//MAP CONVERTED BY dmm2tgm.py THIS HEADER COMMENT PREVENTS RECONVERSION, DO NOT REMOVE
"a" = (
/turf/closed/mineral/random/snow/underground,
/area/icemoon/underground/unexplored/rivers)
"f" = (
/obj/structure/disposalpipe/segment{
	dir = 10
	},
/turf/open/floor/plating/snowed/smoothed/warmer,
/area/maintenance/central/frozen/lower)
"h" = (
/turf/closed/wall/mineral/snow,
/area/maintenance/central/frozen/lower)
"v" = (
/turf/closed/mineral/random/snow/underground,
/area/icemoon/underground/explored)
"C" = (
/obj/structure/cable{
	icon_state = "2-8"
	},
/obj/structure/disposalpipe/segment,
/turf/open/floor/plating/snowed/smoothed/warmer,
/area/maintenance/central/frozen/lower)
"V" = (
/obj/structure/cable{
	icon_state = "1-4"
	},
/obj/structure/disposalpipe/segment{
	dir = 5
	},
/turf/open/floor/plating/snowed/smoothed/warmer,
/area/maintenance/central/frozen/lower)

(1,1,1) = {"
h
h
h
h
h
h
h
f
C
"}
(2,1,1) = {"
h
v
v
v
v
v
h
h
h
"}
(3,1,1) = {"
h
v
v
v
v
v
v
v
v
"}
(4,1,1) = {"
h
v
v
a
a
a
a
a
a
"}
(5,1,1) = {"
h
v
v
a
a
a
a
a
a
"}
(6,1,1) = {"
h
v
v
a
a
a
a
a
a
"}
(7,1,1) = {"
h
v
v
a
a
a
a
a
a
"}
(8,1,1) = {"
h
v
v
a
a
a
a
a
a
"}
(9,1,1) = {"
h
v
v
a
a
a
a
a
a
"}
(10,1,1) = {"
h
v
v
a
a
a
a
a
a
"}
(11,1,1) = {"
h
v
v
a
a
a
a
a
a
"}
(12,1,1) = {"
h
v
v
a
a
a
a
a
a
"}
(13,1,1) = {"
h
v
v
a
a
a
a
a
a
"}
(14,1,1) = {"
h
v
v
a
a
a
a
a
a
"}
(15,1,1) = {"
h
h
v
a
a
a
a
a
a
"}
(16,1,1) = {"
V
h
v
a
a
a
a
a
a
"}
