//MAP CONVERTED BY dmm2tgm.py THIS HEADER COMMENT PREVENTS RECONVERSION, DO NOT REMOVE
"a" = (
/obj/effect/spawner/structure/window/ice,
/turf/open/floor/plating/snowed/smoothed/warmer,
/area/maintenance/central/frozen/lower)
"b" = (
/obj/structure/chair/wood/normal,
/turf/open/floor/grass/fairy/purple,
/area/maintenance/central/frozen/lower)
"c" = (
/turf/closed/wall/mineral/snow,
/area/maintenance/central/frozen/lower)
"d" = (
/obj/structure/flora/stump/mushroom,
/turf/open/floor/grass/fairy/purple,
/area/maintenance/central/frozen/lower)
"e" = (
/obj/structure/flora/biolumi/mine,
/turf/open/floor/grass/fairy/purple,
/area/maintenance/central/frozen/lower)
"f" = (
/turf/open/floor/plasteel/stairs/left{
	dir = 4
	},
/area/maintenance/central/frozen/lower)
"g" = (
/obj/structure/chair/wood/normal{
	dir = 4
	},
/obj/item/reagent_containers/glass/beaker/waterbottle/wataur,
/turf/open/floor/grass/fairy/purple,
/area/maintenance/central/frozen/lower)
"h" = (
/obj/structure/bonfire/prelit,
/turf/open/floor/grass/fairy/purple,
/area/maintenance/central/frozen/lower)
"i" = (
/obj/structure/flora/tree/spookybranch,
/turf/open/floor/grass/fairy/purple,
/area/maintenance/central/frozen/lower)
"k" = (
/obj/structure/flora/tree/spookylog,
/turf/open/floor/grass/fairy/purple,
/area/maintenance/central/frozen/lower)
"p" = (
/turf/open/floor/plating/snowed/smoothed/warmer,
/area/maintenance/central/frozen/lower)
"r" = (
/turf/open/floor/plasteel/stairs/right,
/area/maintenance/central/frozen/lower)
"s" = (
/turf/closed/mineral/random/snow/underground,
/area/icemoon/underground/explored)
"t" = (
/obj/structure/closet/cabinet,
/obj/item/clothing/suit/hooded/wintercoat,
/obj/item/clothing/suit/hooded/wintercoat,
/obj/item/clothing/shoes/winterboots{
	pixel_x = 2;
	pixel_y = -2
	},
/obj/item/clothing/shoes/winterboots{
	pixel_x = 2;
	pixel_y = -2
	},
/turf/open/floor/plating/snowed/smoothed/warmer,
/area/maintenance/central/frozen/lower)
"v" = (
/obj/structure/flora/tree/mushroom,
/turf/open/floor/grass/fairy/purple,
/area/maintenance/central/frozen/lower)
"w" = (
/obj/structure/flora/biolumi/lamp,
/turf/open/floor/grass/fairy/purple,
/area/maintenance/central/frozen/lower)
"A" = (
/turf/open/floor/plasteel/stairs/medium{
	dir = 4
	},
/area/maintenance/central/frozen/lower)
"B" = (
/obj/structure/flora/tree/spookytimexl,
/turf/open/floor/grass/fairy/purple,
/area/maintenance/central/frozen/lower)
"C" = (
/turf/open/floor/grass/fairy/purple,
/area/maintenance/central/frozen/lower)
"D" = (
/obj/structure/flora/biolumi/flower,
/turf/open/floor/grass/fairy/purple,
/area/maintenance/central/frozen/lower)
"G" = (
/turf/open/floor/plasteel/stairs/medium,
/area/maintenance/central/frozen/lower)
"H" = (
/obj/structure/chair/wood/normal{
	dir = 8
	},
/turf/open/floor/grass/fairy/purple,
/area/maintenance/central/frozen/lower)
"K" = (
/turf/open/floor/plasteel/stairs/left,
/area/maintenance/central/frozen/lower)
"M" = (
/obj/structure/cable{
	icon_state = "1-4"
	},
/obj/structure/disposalpipe/segment{
	dir = 5
	},
/turf/open/floor/plating/snowed/smoothed/warmer,
/area/maintenance/central/frozen/lower)
"N" = (
/obj/structure/flora/rock/pile,
/turf/open/floor/grass/fairy/purple,
/area/maintenance/central/frozen/lower)
"Q" = (
/turf/closed/mineral/random/snow/underground,
/area/icemoon/underground/unexplored/rivers)
"R" = (
/obj/structure/flora/tree/pine,
/turf/open/floor/grass/fairy/purple,
/area/maintenance/central/frozen/lower)
"S" = (
/obj/structure/disposalpipe/segment{
	dir = 10
	},
/turf/open/floor/plating/snowed/smoothed/warmer,
/area/maintenance/central/frozen/lower)
"T" = (
/obj/structure/cable{
	icon_state = "2-8"
	},
/obj/structure/disposalpipe/segment,
/turf/open/floor/plating/snowed/smoothed/warmer,
/area/maintenance/central/frozen/lower)
"Y" = (
/turf/open/floor/plasteel/stairs/right{
	dir = 4
	},
/area/maintenance/central/frozen/lower)

(1,1,1) = {"
p
p
p
p
p
t
a
S
T
"}
(2,1,1) = {"
p
p
p
p
p
t
a
a
a
"}
(3,1,1) = {"
p
p
Y
A
A
A
A
f
a
"}
(4,1,1) = {"
p
K
C
C
w
C
C
C
a
"}
(5,1,1) = {"
p
G
i
R
C
C
C
R
a
"}
(6,1,1) = {"
p
G
C
C
C
C
k
C
a
"}
(7,1,1) = {"
p
G
C
C
C
C
v
C
a
"}
(8,1,1) = {"
p
G
D
C
g
C
C
C
a
"}
(9,1,1) = {"
p
G
C
b
h
C
C
C
a
"}
(10,1,1) = {"
p
G
v
C
H
C
C
d
a
"}
(11,1,1) = {"
p
G
C
C
C
C
e
C
a
"}
(12,1,1) = {"
p
G
C
C
C
C
R
C
a
"}
(13,1,1) = {"
p
G
C
C
R
C
C
N
a
"}
(14,1,1) = {"
p
r
w
C
C
C
C
B
a
"}
(15,1,1) = {"
a
a
a
a
a
a
a
a
a
"}
(16,1,1) = {"
M
c
s
Q
Q
Q
Q
Q
Q
"}
