//MAP CONVERTED BY dmm2tgm.py THIS HEADER COMMENT PREVENTS RECONVERSION, DO NOT REMOVE
"a" = (
/turf/closed/wall/mineral/snow,
/area/maintenance/central/frozen/lower)
"c" = (
/obj/structure/disposalpipe/segment{
	dir = 10
	},
/turf/open/floor/plating/snowed/smoothed/warmer,
/area/maintenance/central/frozen/lower)
"g" = (
/obj/machinery/door/airlock/public/glass,
/turf/open/floor/plating/snowed/smoothed/warmer,
/area/maintenance/central/frozen/lower)
"l" = (
/turf/closed/mineral/random/snow/underground,
/area/icemoon/underground/unexplored/rivers)
"m" = (
/turf/open/floor/plating/snowed/smoothed/warmer,
/area/maintenance/central/frozen/lower)
"o" = (
/obj/effect/spawner/structure/window/ice,
/turf/open/floor/plating/snowed/smoothed/warmer,
/area/maintenance/central/frozen/lower)
"r" = (
/obj/effect/decal/cleanable/semendrip,
/turf/open/floor/plating,
/area/maintenance/central/frozen/lower)
"x" = (
/obj/item/clothing/head/that{
	desc = "It's an amish looking hat. This one is sticky with some white fluid."
	},
/obj/effect/decal/cleanable/semen,
/turf/open/floor/plating,
/area/maintenance/central/frozen/lower)
"L" = (
/obj/structure/cable{
	icon_state = "2-8"
	},
/obj/structure/disposalpipe/segment,
/turf/open/floor/plating/snowed/smoothed/warmer,
/area/maintenance/central/frozen/lower)
"Q" = (
/obj/structure/cable{
	icon_state = "1-4"
	},
/obj/structure/disposalpipe/segment{
	dir = 5
	},
/turf/open/floor/plating/snowed/smoothed/warmer,
/area/maintenance/central/frozen/lower)
"S" = (
/turf/closed/mineral/random/snow/underground,
/area/icemoon/underground/explored)
"Z" = (
/turf/open/floor/plating,
/area/maintenance/central/frozen/lower)

(1,1,1) = {"
a
a
a
a
a
g
a
c
L
"}
(2,1,1) = {"
a
S
S
S
o
m
a
a
a
"}
(3,1,1) = {"
a
S
S
S
o
m
a
S
S
"}
(4,1,1) = {"
a
S
S
S
o
m
a
l
l
"}
(5,1,1) = {"
a
S
S
S
o
m
a
l
l
"}
(6,1,1) = {"
a
S
S
a
a
g
a
a
l
"}
(7,1,1) = {"
a
o
o
a
r
Z
Z
a
l
"}
(8,1,1) = {"
g
m
m
g
Z
x
r
a
l
"}
(9,1,1) = {"
a
a
a
a
r
Z
Z
a
l
"}
(10,1,1) = {"
a
S
S
a
a
a
a
a
l
"}
(11,1,1) = {"
a
S
S
l
l
l
l
l
l
"}
(12,1,1) = {"
a
S
S
l
l
l
l
l
l
"}
(13,1,1) = {"
a
S
S
l
l
l
l
l
l
"}
(14,1,1) = {"
a
S
S
l
l
l
l
l
l
"}
(15,1,1) = {"
a
a
S
l
l
l
l
l
l
"}
(16,1,1) = {"
Q
a
S
l
l
l
l
l
l
"}
