//MAP CONVERTED BY dmm2tgm.py THIS HEADER COMMENT PREVENTS RECONVERSION, DO NOT REMOVE
"aa" = (
/turf/open/lava/smooth/lava_land_surface,
/area/lavaland/surface/outdoors)
"ab" = (
/turf/closed/wall/mineral/iron,
/area/ruin/space/has_grav)
"ay" = (
/obj/structure/closet/crate/coffin,
/obj/item/immortality_talisman,
/obj/effect/mob_spawn/human/skeleton,
/turf/open/floor/mineral/diamond,
/area/ruin/space/has_grav)
"az" = (
/obj/structure/table,
/obj/item/wisp_lantern,
/obj/structure/sign/warning/securearea{
	desc = "Under the painting a plaque reads: 'While the meat grinder may not have spared you, fear not. Not one part of you has gone to waste... You were delicious.'";
	icon_state = "monkey_painting";
	name = "Mr. Deempisi portrait";
	pixel_x = 0;
	pixel_y = 28
	},
/turf/open/floor/mineral/diamond,
/area/ruin/space/has_grav)
"aD" = (
/obj/item/chair,
/turf/open/floor/mineral/diamond,
/area/ruin/space/has_grav)
"aE" = (
/obj/structure/table,
/obj/item/book/codex_gigas,
/turf/open/floor/mineral/diamond,
/area/ruin/space/has_grav)
"aG" = (
/obj/structure/mineral_door/transparent/diamond,
/obj/structure/fans/tiny/invisible,
/turf/open/floor/mineral/diamond,
/area/ruin/space/has_grav)
"aO" = (
/turf/template_noop,
/area/template_noop)
"aP" = (
/turf/open/floor/plating/asteroid/basalt/lava_land_surface,
/area/lavaland/surface/outdoors)
"aR" = (
/obj/effect/decal/remains/human,
/turf/open/floor/plating/asteroid/basalt/lava_land_surface,
/area/lavaland/surface/outdoors)
"aS" = (
/obj/effect/mob_spawn/human/skeleton,
/turf/open/floor/plating/asteroid/basalt/lava_land_surface,
/area/lavaland/surface/outdoors)
"aT" = (
/turf/open/floor/plasteel/dark/lavaland,
/area/lavaland/surface/outdoors)
"aU" = (
/turf/open/floor/plasteel/dark/lavaland,
/area/ruin/space/has_grav)
"bm" = (
/turf/open/lava/smooth/lava_land_surface,
/area/ruin/space/has_grav)
"bz" = (
/obj/item/flashlight/lantern,
/turf/open/floor/plasteel/dark/lavaland,
/area/ruin/space/has_grav)
"cZ" = (
/obj/effect/decal/cleanable/dirt,
/turf/open/lava/smooth/lava_land_surface,
/area/ruin/space/has_grav)
"fj" = (
/obj/item/stack/sheet/mineral/silver,
/turf/open/floor/plating/lavaland_baseturf{
	icon_state = "panelscorched"
	},
/area/ruin/space/has_grav)
"gH" = (
/obj/structure/closet/crate/coffin,
/obj/effect/decal/cleanable/dirt,
/turf/open/floor/plasteel/dark/lavaland,
/area/ruin/space/has_grav)
"hN" = (
/mob/living/simple_animal/hostile/skeleton/templar{
	aggro_vision_range = 3;
	speak = list("THE NECROPOLIS WILLS IT!","DEUS VULT!","REMOVE KABAB!");
	speak_chance = 0
	},
/turf/open/floor/plasteel/dark/lavaland,
/area/ruin/space/has_grav)
"kz" = (
/obj/item/coin/gold,
/obj/effect/decal/remains/human,
/turf/open/floor/plating/lavaland_baseturf{
	icon_state = "panelscorched"
	},
/area/ruin/space/has_grav)
"lA" = (
/obj/effect/decal/cleanable/blood/old,
/obj/item/stack/sheet/mineral/gold,
/turf/open/floor/plasteel/dark/lavaland,
/area/ruin/space/has_grav)
"lL" = (
/obj/effect/decal/cleanable/dirt,
/turf/open/floor/plasteel/dark/lavaland,
/area/ruin/space/has_grav)
"on" = (
/mob/living/simple_animal/hostile/skeleton/templar{
	speak = list("THE NECROPOLIS WILLS IT!","DEUS VULT!","REMOVE KABAB!");
	speak_chance = 0
	},
/turf/open/floor/plasteel/dark/lavaland,
/area/ruin/space/has_grav)
"oF" = (
/obj/effect/decal/cleanable/blood/old,
/obj/effect/decal/cleanable/blood/old,
/turf/open/floor/plasteel/dark/lavaland,
/area/ruin/space/has_grav)
"oH" = (
/mob/living/simple_animal/hostile/skeleton,
/turf/open/floor/plasteel/dark/lavaland,
/area/ruin/space/has_grav)
"rp" = (
/turf/closed/wall/mineral/iron{
	desc = "A wall with rough metal plating. Looks like it would take ages to slice it open with a welder.";
	name = "tough metal wall";
	slicing_duration = 5000
	},
/area/ruin/space/has_grav)
"rQ" = (
/mob/living/simple_animal/hostile/skeleton/eskimo,
/turf/open/floor/plasteel/dark/lavaland,
/area/ruin/space/has_grav)
"sL" = (
/obj/effect/decal/cleanable/dirt,
/mob/living/simple_animal/hostile/skeleton,
/turf/open/floor/plasteel/dark/lavaland,
/area/ruin/space/has_grav)
"vp" = (
/obj/structure/closet/crate/coffin,
/obj/effect/mob_spawn/human/skeleton,
/turf/open/floor/plasteel/dark/lavaland,
/area/ruin/space/has_grav)
"vW" = (
/obj/structure/closet/crate/coffin,
/turf/open/floor/plasteel/dark/lavaland,
/area/ruin/space/has_grav)
"wl" = (
/obj/structure/closet/crate/coffin,
/obj/effect/mob_spawn/human/skeleton,
/obj/item/shield/riot/buckler,
/turf/open/floor/plasteel/dark/lavaland,
/area/ruin/space/has_grav)
"wq" = (
/obj/structure/mineral_door/gold,
/obj/structure/fans/tiny/invisible,
/turf/open/floor/plasteel/dark/lavaland,
/area/ruin/space/has_grav)
"yj" = (
/obj/item/stack/sheet/mineral/gold,
/turf/open/floor/plasteel/dark/lavaland,
/area/ruin/space/has_grav)
"zg" = (
/obj/effect/decal/cleanable/dirt,
/obj/effect/decal/cleanable/dirt,
/mob/living/simple_animal/hostile/skeleton/templar{
	speak = list("THE NECROPOLIS WILLS IT!","DEUS VULT!","REMOVE KABAB!");
	speak_chance = 0
	},
/turf/open/floor/mineral/diamond,
/area/ruin/space/has_grav)
"AP" = (
/obj/effect/decal/cleanable/blood/old,
/turf/open/floor/plasteel/dark/lavaland,
/area/ruin/space/has_grav)
"BF" = (
/obj/effect/decal/cleanable/dirt,
/turf/open/floor/plating/lavaland_baseturf{
	icon_state = "panelscorched"
	},
/area/ruin/space/has_grav)
"BJ" = (
/obj/structure/closet/crate/coffin,
/obj/item/shield/riot/buckler,
/turf/open/floor/plasteel/dark/lavaland,
/area/ruin/space/has_grav)
"Ch" = (
/obj/effect/mob_spawn/human/skeleton,
/turf/open/floor/plasteel/dark/lavaland,
/area/ruin/space/has_grav)
"Gf" = (
/turf/open/floor/plating/lavaland_baseturf{
	icon_state = "panelscorched"
	},
/area/ruin/space/has_grav)
"GV" = (
/obj/effect/decal/cleanable/dirt,
/obj/item/slimecross/industrial/silver,
/obj/item/slimecross/industrial/silver,
/turf/open/floor/plasteel/dark/lavaland,
/area/ruin/space/has_grav)
"Hm" = (
/obj/item/stack/sheet/mineral/gold,
/mob/living/simple_animal/hostile/skeleton/templar{
	aggro_vision_range = 3;
	speak = list("THE NECROPOLIS WILLS IT!","DEUS VULT!","REMOVE KABAB!");
	speak_chance = 0
	},
/turf/open/floor/plasteel/dark/lavaland,
/area/ruin/space/has_grav)
"Ic" = (
/obj/item/stack/sheet/mineral/silver,
/turf/open/floor/plasteel/dark/lavaland,
/area/ruin/space/has_grav)
"NG" = (
/obj/item/spear/cerberus,
/turf/open/floor/plating/lavaland_baseturf{
	icon_state = "panelscorched"
	},
/area/ruin/space/has_grav)
"Pa" = (
/obj/structure/closet/crate/coffin,
/obj/effect/decal/cleanable/dirt,
/obj/item/shield/riot/buckler,
/turf/open/floor/plasteel/dark/lavaland,
/area/ruin/space/has_grav)
"QE" = (
/obj/effect/decal/cleanable/dirt,
/obj/effect/decal/remains/human,
/turf/open/floor/plasteel/dark/lavaland,
/area/ruin/space/has_grav)
"SY" = (
/obj/item/coin/gold,
/turf/open/floor/plating/lavaland_baseturf{
	icon_state = "panelscorched"
	},
/area/ruin/space/has_grav)
"TE" = (
/obj/effect/decal/remains/human,
/turf/open/floor/plasteel/dark/lavaland,
/area/ruin/space/has_grav)
"Uf" = (
/obj/structure/mineral_door/iron,
/obj/structure/fans/tiny/invisible,
/turf/open/floor/plasteel/dark/lavaland,
/area/ruin/space/has_grav)
"Vw" = (
/obj/effect/decal/cleanable/dirt,
/obj/effect/decal/remains/human,
/obj/item/coin/gold,
/turf/open/floor/plasteel/dark/lavaland,
/area/ruin/space/has_grav)
"Wd" = (
/obj/structure/table,
/obj/item/stack/sheet/mineral/diamond,
/turf/open/floor/mineral/diamond,
/area/ruin/space/has_grav)
"Xa" = (
/obj/item/slimecross/industrial/silver,
/turf/open/floor/plating/lavaland_baseturf{
	icon_state = "panelscorched"
	},
/area/ruin/space/has_grav)
"Xo" = (
/obj/structure/closet/crate/coffin,
/obj/effect/mob_spawn/human/skeleton,
/obj/effect/decal/cleanable/dirt,
/turf/open/floor/plasteel/dark/lavaland,
/area/ruin/space/has_grav)
"Yc" = (
/obj/item/coin/gold,
/turf/open/floor/plasteel/dark/lavaland,
/area/ruin/space/has_grav)
"Zf" = (
/obj/item/slimecross/industrial/silver,
/turf/open/floor/plasteel/dark/lavaland,
/area/ruin/space/has_grav)

(1,1,1) = {"
aa
aa
aa
aa
aa
aa
aa
aa
aa
aa
aa
aa
aa
aa
aa
aa
aa
aa
aa
aa
aa
aO
aO
aO
aO
aO
aO
aO
"}
(2,1,1) = {"
aa
ab
ab
ab
aa
ab
aa
ab
aa
ab
aa
ab
aa
ab
aa
ab
aa
ab
ab
ab
aa
aO
aO
aO
aO
aO
aO
aO
"}
(3,1,1) = {"
aa
ab
ab
ab
ab
ab
ab
ab
ab
ab
ab
ab
ab
ab
ab
ab
ab
ab
ab
ab
aa
aO
aO
aO
aO
aO
aO
aO
"}
(4,1,1) = {"
aa
ab
ab
ab
ab
ab
ab
ab
ab
ab
ab
ab
ab
ab
ab
ab
ab
ab
ab
ab
aa
aO
aO
aO
aO
aO
aO
aO
"}
(5,1,1) = {"
aa
aa
ab
ab
vp
aU
lL
lL
aU
wq
hN
aU
aU
aU
Vw
hN
Yc
ab
ab
aa
aa
aO
aP
aP
aP
aP
aP
aO
"}
(6,1,1) = {"
aa
ab
ab
ab
wl
aU
lL
TE
aU
wq
aU
lL
hN
Ic
BF
aU
lL
ab
ab
ab
aa
aP
aP
aR
aP
aR
aP
aO
"}
(7,1,1) = {"
aa
aa
ab
ab
ab
ab
Uf
ab
ab
ab
aU
Zf
AP
ab
lA
aU
Gf
Gf
bm
aa
aa
aP
aP
aR
aR
aP
aR
aO
"}
(8,1,1) = {"
aa
ab
ab
ab
BJ
aU
lL
aU
Xo
ab
Hm
aU
aU
aU
SY
Ch
fj
ab
NG
ab
aa
aP
aP
aS
aR
aP
aP
aO
"}
(9,1,1) = {"
aa
aa
ab
ab
ab
lL
TE
aU
ab
ab
Zf
GV
yj
kz
bm
bm
bm
bm
bm
aa
aa
aP
aP
aR
aS
aR
aP
aO
"}
(10,1,1) = {"
aa
ab
ab
ab
vp
aU
oF
lL
Pa
ab
aU
aU
Xa
cZ
bm
bm
bm
bm
bm
bm
aa
aP
aP
aT
aP
aP
aO
aO
"}
(11,1,1) = {"
aa
aa
ab
ab
ab
aU
on
aU
ab
rp
rp
aG
rp
bm
bm
bm
bm
bm
bm
aa
aa
aP
aP
aP
aT
aO
aO
aO
"}
(12,1,1) = {"
aa
ab
ab
ab
wl
aU
lL
aU
vp
rp
ay
zg
rp
bm
ab
Xa
BF
ab
ab
ab
aa
aP
aP
aP
aP
aO
aO
aO
"}
(13,1,1) = {"
aa
aa
ab
ab
ab
aU
aU
aU
ab
rp
az
aD
rp
bm
bm
BF
bz
ab
ab
aU
aU
aP
aP
aT
aP
aO
aO
aO
"}
(14,1,1) = {"
aa
ab
ab
ab
gH
aU
aU
aU
vW
rp
Wd
aE
rp
bm
bm
Gf
aU
Uf
aU
aU
aU
aT
aT
aT
aO
aO
aO
aO
"}
(15,1,1) = {"
aa
aa
ab
ab
ab
ab
Uf
ab
ab
rp
rp
rp
rp
ab
ab
ab
Uf
ab
ab
aU
aU
aP
aP
aP
aO
aO
aO
aO
"}
(16,1,1) = {"
aa
ab
ab
ab
aU
aU
aU
aU
aU
Uf
AP
aU
aU
aU
aU
lL
aU
ab
ab
ab
aa
aP
aP
aP
aO
aO
aO
aO
"}
(17,1,1) = {"
aa
aa
ab
ab
aU
lL
AP
rQ
lL
ab
aU
aU
QE
oH
aU
aU
aU
ab
ab
aa
aa
aO
aO
aO
aO
aO
aO
aO
"}
(18,1,1) = {"
aa
ab
ab
ab
aU
rQ
Ch
aU
aU
ab
aU
oH
aU
ab
aU
oH
aU
ab
ab
ab
aa
aO
aO
aO
aO
aO
aO
aO
"}
(19,1,1) = {"
aa
aa
ab
ab
lL
aU
lL
QE
aU
Uf
aU
lL
AP
ab
aU
Ch
lL
ab
ab
aa
aa
aO
aO
aO
aO
aO
aO
aO
"}
(20,1,1) = {"
aa
ab
ab
ab
aU
aU
rQ
aU
aU
ab
aU
oH
aU
aU
aU
aU
aU
ab
ab
ab
aa
aO
aO
aO
aO
aO
aO
aO
"}
(21,1,1) = {"
aa
aa
ab
ab
aU
lL
aU
aU
aU
Uf
aU
aU
aU
aU
sL
aU
aU
ab
ab
aa
aa
aO
aO
aO
aO
aO
aO
aO
"}
(22,1,1) = {"
aa
ab
ab
ab
ab
ab
ab
ab
ab
ab
ab
ab
ab
ab
ab
ab
ab
ab
ab
ab
aa
aO
aO
aO
aO
aO
aO
aO
"}
(23,1,1) = {"
aa
ab
ab
ab
ab
ab
ab
ab
ab
ab
ab
ab
ab
ab
ab
ab
ab
ab
ab
ab
aa
aO
aO
aO
aO
aO
aO
aO
"}
(24,1,1) = {"
aa
ab
ab
ab
aa
ab
aa
ab
aa
ab
aa
ab
aa
ab
aa
ab
aa
ab
ab
ab
aa
aO
aO
aO
aO
aO
aO
aO
"}
(25,1,1) = {"
aa
aa
aa
aa
aa
aa
aa
aa
aa
aa
aa
aa
aa
aa
aa
aa
aa
aa
aa
aa
aa
aO
aO
aO
aO
aO
aO
aO
"}
