//MAP CONVERTED BY dmm2tgm.py THIS HEADER COMMENT PREVENTS RECONVERSION, DO NOT REMOVE
"a" = (
/turf/closed/wall/mineral/titanium,
/area/shuttle/snowtaxi)
"b" = (
/obj/structure/chair/comfy/shuttle{
	dir = 1
	},
/obj/machinery/light,
/turf/open/floor/mineral/titanium/tiled,
/area/shuttle/snowtaxi)
"e" = (
/obj/effect/spawner/structure/window/shuttle,
/obj/structure/fans/tiny/invisible,
/turf/open/floor/plating,
/area/shuttle/snowtaxi)
"f" = (
/obj/structure/chair/comfy/shuttle,
/obj/machinery/light{
	dir = 1
	},
/turf/open/floor/mineral/titanium/tiled,
/area/shuttle/snowtaxi)
"g" = (
/obj/machinery/door/airlock/titanium{
	name = "Mining Shuttle Airlock"
	},
/obj/docking_port/mobile{
	callTime = 5;
	dwidth = 3;
	height = 4;
	shuttle_id = "snow_taxi";
	name = "snow taxi";
	port_direction = 8;
	width = 6
	},
/obj/effect/mapping_helpers/airlock/cyclelink_helper{
	dir = 1
	},
/obj/structure/fans/tiny,
/turf/open/floor/plating,
/area/shuttle/snowtaxi)
"i" = (
/obj/machinery/light,
/obj/structure/chair/comfy/shuttle{
	dir = 1
	},
/turf/open/floor/mineral/titanium/tiled,
/area/shuttle/snowtaxi)
"j" = (
/obj/structure/chair/comfy/shuttle{
	dir = 1
	},
/turf/open/floor/mineral/titanium/tiled,
/area/shuttle/snowtaxi)
"k" = (
/turf/open/floor/mineral/titanium/blue,
/area/shuttle/snowtaxi)
"l" = (
/obj/structure/fans/tiny/invisible,
/obj/effect/spawner/structure/window/shuttle,
/turf/open/floor/plating/airless,
/area/shuttle/snowtaxi)
"u" = (
/obj/structure/chair/comfy/shuttle,
/turf/open/floor/mineral/titanium/tiled,
/area/shuttle/snowtaxi)
"D" = (
/obj/structure/fans/tiny/invisible,
/obj/effect/spawner/structure/window/shuttle,
/turf/open/floor/plating,
/area/shuttle/snowtaxi)
"E" = (
/obj/structure/shuttle/engine/propulsion/burst{
	dir = 4
	},
/obj/structure/window/reinforced{
	dir = 8
	},
/obj/structure/fans/tiny/invisible,
/turf/open/floor/plating,
/area/shuttle/snowtaxi)
"S" = (
/obj/machinery/light{
	dir = 1
	},
/obj/machinery/computer/shuttle/snow_taxi{
	dir = 2
	},
/turf/open/floor/mineral/titanium/tiled,
/area/shuttle/snowtaxi)
"W" = (
/obj/machinery/door/airlock/titanium{
	name = "Mining Shuttle Airlock"
	},
/obj/structure/fans/tiny,
/obj/effect/mapping_helpers/airlock/cyclelink_helper,
/turf/open/floor/plating,
/area/shuttle/snowtaxi)

(1,1,1) = {"
a
e
D
e
a
"}
(2,1,1) = {"
a
S
k
i
a
"}
(3,1,1) = {"
e
u
k
j
l
"}
(4,1,1) = {"
W
k
k
k
g
"}
(5,1,1) = {"
e
u
k
j
D
"}
(6,1,1) = {"
a
f
k
b
a
"}
(7,1,1) = {"
a
E
E
E
a
"}
