//MAP CONVERTED BY dmm2tgm.py THIS HEADER COMMENT PREVENTS RECONVERSION, DO NOT REMOVE
"a" = (
/turf/open/floor/plating/asteroid/snow/icemoon,
/area/icemoon/surface/outdoors)
"b" = (
/obj/structure/disposalpipe/segment,
/obj/machinery/atmospherics/pipe/simple/supply/hidden/layer1,
/obj/machinery/atmospherics/pipe/simple/scrubbers/hidden/layer3,
/turf/open/floor/plating/snowed/smoothed/warmer,
/area/maintenance/central/frozen/upper)
"c" = (
/obj/effect/spawner/structure/window/reinforced,
/turf/open/floor/plating,
/area/icemoon/surface/outdoors)
"d" = (
/obj/item/stack/rods{
	amount = 2
	},
/obj/structure/sign/poster/ripped{
	pixel_x = 32
	},
/turf/open/floor/plating/airless,
/area/maintenance/department/science)
"e" = (
/obj/machinery/light/small{
	dir = 8
	},
/turf/open/floor/plating,
/area/maintenance/department/science)
"g" = (
/obj/structure/disposalpipe/segment{
	dir = 9
	},
/obj/machinery/atmospherics/pipe/simple/supply/hidden/layer1{
	dir = 9
	},
/obj/machinery/atmospherics/pipe/simple/scrubbers/hidden/layer3{
	dir = 9
	},
/turf/open/floor/plating/snowed/smoothed/warmer,
/area/maintenance/central/frozen/upper)
"h" = (
/obj/structure/cable{
	icon_state = "4-8"
	},
/obj/machinery/light/floor,
/obj/structure/disposalpipe/segment{
	dir = 4
	},
/turf/open/floor/plating/snowed/smoothed/warmer,
/area/maintenance/central/frozen/upper)
"i" = (
/turf/closed/mineral/random/snow,
/area/icemoon/underground/unexplored/rivers)
"j" = (
/obj/structure/rack,
/obj/effect/spawner/lootdrop/maintenance{
	lootcount = 2;
	name = "2maintenance loot spawner"
	},
/turf/open/floor/plating/airless,
/area/icemoon/surface/outdoors)
"l" = (
/obj/machinery/light/floor,
/obj/structure/disposalpipe/segment,
/obj/machinery/atmospherics/pipe/simple/supply/hidden/layer1,
/obj/machinery/atmospherics/pipe/simple/scrubbers/hidden/layer3,
/turf/open/floor/plating/snowed/smoothed/warmer,
/area/maintenance/central/frozen/upper)
"m" = (
/obj/structure/railing{
	dir = 6
	},
/turf/open/floor/plating,
/area/maintenance/department/science)
"n" = (
/obj/structure/cable{
	icon_state = "4-8"
	},
/obj/structure/disposalpipe/segment{
	dir = 4
	},
/turf/open/floor/plating/snowed/smoothed/warmer,
/area/maintenance/central/frozen/upper)
"o" = (
/turf/open/floor/plating/asteroid/snow/icemoon,
/area/icemoon/underground/unexplored/rivers)
"p" = (
/obj/structure/disposalpipe/segment{
	dir = 6
	},
/obj/machinery/atmospherics/pipe/simple/supply/hidden/layer1{
	dir = 6
	},
/obj/machinery/atmospherics/pipe/simple/scrubbers/hidden/layer3{
	dir = 6
	},
/turf/open/floor/plating/snowed/smoothed/warmer,
/area/maintenance/central/frozen/upper)
"q" = (
/obj/machinery/light/floor,
/obj/structure/disposalpipe/segment{
	dir = 4
	},
/obj/machinery/atmospherics/pipe/simple/supply/hidden/layer1{
	dir = 4
	},
/obj/machinery/atmospherics/pipe/simple/scrubbers/hidden/layer3{
	dir = 4
	},
/turf/open/floor/plating/snowed/smoothed/warmer,
/area/maintenance/central/frozen/upper)
"r" = (
/turf/closed/mineral/random/snow,
/area/maintenance/department/science)
"s" = (
/obj/structure/barricade/wooden/snowed,
/turf/open/floor/plating/airless,
/area/icemoon/surface/outdoors)
"u" = (
/obj/structure/grille/broken,
/turf/open/floor/plating/airless,
/area/icemoon/surface/outdoors)
"v" = (
/obj/structure/rack,
/obj/effect/spawner/lootdrop/maintenance{
	lootcount = 3;
	name = "3maintenance loot spawner"
	},
/turf/open/floor/plating/airless,
/area/icemoon/surface/outdoors)
"w" = (
/obj/item/stack/rods{
	amount = 2
	},
/obj/structure/sign/warning/nosmoking{
	pixel_x = 32
	},
/turf/open/floor/plating/airless,
/area/maintenance/department/science)
"x" = (
/obj/item/stack/rods{
	amount = 2
	},
/turf/open/floor/plating/airless,
/area/icemoon/surface/outdoors)
"y" = (
/obj/structure/cable{
	icon_state = "2-4"
	},
/obj/structure/disposalpipe/segment{
	dir = 6
	},
/turf/open/floor/plating/snowed/smoothed/warmer,
/area/maintenance/central/frozen/upper)
"z" = (
/obj/machinery/light/broken{
	dir = 4
	},
/turf/open/floor/plating/airless,
/area/maintenance/department/science)
"A" = (
/obj/machinery/door/airlock/maintenance{
	req_access_txt = "12"
	},
/turf/open/floor/plating,
/area/maintenance/department/science)
"B" = (
/obj/structure/ladder,
/obj/structure/railing{
	dir = 4
	},
/turf/open/floor/plating,
/area/maintenance/department/science)
"C" = (
/obj/machinery/light/small,
/turf/open/floor/plating,
/area/maintenance/department/science)
"D" = (
/obj/structure/disposalpipe/segment{
	dir = 4
	},
/obj/machinery/atmospherics/pipe/simple/supply/hidden/layer1{
	dir = 4
	},
/obj/machinery/atmospherics/pipe/simple/scrubbers/hidden/layer3{
	dir = 4
	},
/turf/open/floor/plating/snowed/smoothed/warmer,
/area/maintenance/central/frozen/upper)
"G" = (
/obj/structure/cable{
	icon_state = "1-8"
	},
/obj/structure/disposalpipe/segment{
	dir = 9
	},
/turf/open/floor/plating/snowed/smoothed/warmer,
/area/maintenance/central/frozen/upper)
"H" = (
/turf/closed/wall,
/area/icemoon/surface/outdoors)
"I" = (
/obj/effect/spawner/structure/window/reinforced,
/turf/open/floor/plating,
/area/maintenance/department/science)
"J" = (
/obj/structure/cable{
	icon_state = "1-2"
	},
/obj/structure/disposalpipe/segment,
/turf/open/floor/plating/snowed/smoothed/warmer,
/area/maintenance/central/frozen/upper)
"K" = (
/turf/closed/mineral/random/snow,
/area/icemoon/surface/outdoors)
"L" = (
/obj/item/chair,
/obj/effect/decal/cleanable/glass,
/turf/open/floor/plating/airless,
/area/icemoon/surface/outdoors)
"M" = (
/turf/closed/wall/mineral/snow,
/area/maintenance/central/frozen/upper)
"N" = (
/obj/structure/girder,
/turf/open/floor/plating/asteroid/snow/icemoon,
/area/icemoon/surface/outdoors)
"O" = (
/obj/structure/disposalpipe/segment{
	dir = 4
	},
/obj/machinery/atmospherics/pipe/simple/supply/hidden/layer1{
	dir = 4
	},
/obj/machinery/atmospherics/pipe/simple/scrubbers/hidden/layer3{
	dir = 4
	},
/obj/machinery/light/floor,
/turf/open/floor/plating/snowed/smoothed/warmer,
/area/maintenance/central/frozen/upper)
"P" = (
/obj/structure/rack,
/obj/item/clothing/head/papersack,
/obj/structure/railing/corner,
/turf/open/floor/plating,
/area/maintenance/department/science)
"Q" = (
/obj/structure/girder,
/turf/open/floor/plating/airless,
/area/maintenance/department/science)
"R" = (
/turf/open/floor/plating,
/area/maintenance/department/science)
"S" = (
/turf/closed/mineral/random/snow,
/area/maintenance/central/frozen/upper)
"T" = (
/obj/item/stack/rods{
	amount = 2
	},
/obj/structure/sign/poster/ripped{
	pixel_y = -32
	},
/turf/open/floor/plating/asteroid/snow/icemoon,
/area/icemoon/surface/outdoors)
"V" = (
/turf/open/floor/plating/airless,
/area/icemoon/surface/outdoors)
"W" = (
/obj/structure/railing,
/turf/open/floor/plating,
/area/maintenance/department/science)
"X" = (
/turf/closed/wall,
/area/maintenance/department/science)
"Y" = (
/obj/structure/table_frame,
/turf/open/floor/plating/airless,
/area/icemoon/surface/outdoors)
"Z" = (
/turf/open/floor/plating/asteroid/snow/icemoon,
/area/maintenance/department/science)

(1,1,1) = {"
H
a
u
N
H
K
K
i
i
i
K
K
M
n
D
M
K
K
i
i
i
i
i
i
i
i
i
i
i
i
i
i
i
i
i
"}
(2,1,1) = {"
Y
Y
s
V
H
K
K
i
i
i
K
K
M
n
q
M
K
K
i
i
i
i
i
i
i
i
i
i
i
i
i
i
i
i
i
"}
(3,1,1) = {"
a
L
V
j
N
K
K
K
i
o
a
a
M
n
D
M
K
K
i
i
i
i
i
i
i
i
i
i
i
i
i
i
i
i
i
"}
(4,1,1) = {"
x
v
V
T
H
K
K
K
i
i
K
K
M
n
D
M
K
K
i
i
i
i
i
i
i
i
i
i
i
i
i
i
i
i
i
"}
(5,1,1) = {"
d
z
w
Q
X
r
K
K
i
i
K
K
M
n
D
M
K
K
i
i
i
i
i
i
i
i
i
i
i
i
i
i
i
i
i
"}
(6,1,1) = {"
X
X
X
X
X
X
K
K
i
i
K
K
M
n
D
M
K
K
i
i
i
i
i
i
i
i
i
i
i
i
i
i
i
i
i
"}
(7,1,1) = {"
e
R
R
R
R
X
K
K
i
i
K
K
M
n
D
M
K
K
i
i
i
i
i
i
i
i
i
i
i
i
i
i
i
i
i
"}
(8,1,1) = {"
c
c
c
X
A
X
K
K
i
i
K
K
M
n
D
M
K
K
i
i
i
i
i
i
i
i
i
i
i
i
i
i
i
i
i
"}
(9,1,1) = {"
a
a
a
I
R
I
a
a
K
K
K
K
M
n
q
M
K
K
i
i
i
i
i
i
i
i
i
i
i
i
i
i
i
i
i
"}
(10,1,1) = {"
o
a
a
I
R
I
Z
a
a
K
K
K
M
n
D
M
K
K
i
i
i
i
i
i
i
i
i
i
i
i
i
i
i
i
i
"}
(11,1,1) = {"
o
a
a
X
R
X
X
a
a
K
K
K
M
n
D
M
K
K
i
i
i
i
i
i
i
i
i
i
i
i
i
i
i
i
i
"}
(12,1,1) = {"
o
a
a
X
R
P
X
r
a
K
K
K
M
n
D
M
K
K
i
i
i
i
i
i
i
i
i
i
i
i
i
i
i
i
i
"}
(13,1,1) = {"
o
a
a
X
R
W
X
X
K
K
K
K
M
n
D
M
K
K
i
i
i
i
i
i
i
i
i
i
i
i
i
i
i
i
i
"}
(14,1,1) = {"
o
a
K
X
B
m
R
X
K
K
K
K
M
n
D
M
K
K
i
i
i
i
i
i
i
i
i
i
i
i
i
i
i
i
i
"}
(15,1,1) = {"
o
a
K
X
R
R
C
X
K
K
K
K
M
n
D
M
K
K
i
i
i
i
i
i
i
i
i
i
i
i
i
i
i
i
i
"}
(16,1,1) = {"
i
K
K
H
c
c
c
H
K
K
K
K
M
n
q
M
K
K
i
i
i
i
i
i
i
i
i
i
i
i
i
i
i
i
i
"}
(17,1,1) = {"
i
K
K
K
a
a
a
K
K
i
K
K
M
n
D
M
K
K
i
i
i
i
i
i
i
i
i
i
i
i
i
i
i
i
i
"}
(18,1,1) = {"
i
i
i
o
o
o
o
i
i
i
K
K
M
n
D
M
K
K
i
i
i
i
i
i
i
i
i
i
i
i
i
i
i
i
i
"}
(19,1,1) = {"
i
i
i
o
o
o
o
o
i
i
K
K
M
n
D
M
K
K
i
i
i
i
i
i
i
i
i
i
i
i
i
i
i
i
i
"}
(20,1,1) = {"
i
i
i
i
o
o
o
i
i
i
K
K
M
n
D
M
K
K
i
i
i
i
i
i
i
i
i
i
i
i
i
i
i
i
i
"}
(21,1,1) = {"
i
i
i
i
i
i
i
i
i
i
K
K
M
n
D
M
K
K
i
i
i
i
i
i
i
i
i
i
i
i
i
i
i
i
i
"}
(22,1,1) = {"
i
i
i
i
i
i
i
i
i
i
K
K
M
n
D
M
K
K
i
i
i
i
i
i
i
i
i
i
i
i
i
i
i
i
i
"}
(23,1,1) = {"
i
i
i
i
i
i
i
i
i
i
K
K
M
n
q
M
K
K
i
i
i
i
i
i
i
i
i
i
i
i
i
i
i
i
i
"}
(24,1,1) = {"
i
i
i
i
i
i
i
i
i
i
K
K
M
n
D
M
K
K
i
i
i
i
i
i
i
i
i
i
i
i
i
i
i
i
i
"}
(25,1,1) = {"
i
i
i
i
i
i
i
i
i
i
K
K
M
n
D
M
K
K
i
i
i
i
i
i
i
i
i
i
i
i
i
i
i
i
i
"}
(26,1,1) = {"
i
i
i
i
i
i
i
i
i
i
K
K
M
n
D
M
K
K
i
i
i
i
i
i
i
i
i
i
i
i
i
i
i
i
i
"}
(27,1,1) = {"
i
i
i
i
i
i
i
i
i
i
K
K
M
n
D
M
K
K
i
i
i
i
i
i
i
i
i
i
i
i
i
i
i
i
i
"}
(28,1,1) = {"
i
i
i
i
i
i
i
i
i
i
K
K
M
n
D
M
K
K
i
i
i
i
i
i
i
i
i
i
i
i
i
i
i
i
i
"}
(29,1,1) = {"
i
i
i
i
i
i
i
i
i
i
K
K
M
n
O
M
K
K
i
i
i
i
i
i
i
i
i
i
i
i
i
i
i
i
i
"}
(30,1,1) = {"
i
i
i
i
i
i
i
i
i
i
K
K
M
n
D
M
K
K
i
i
i
i
i
i
i
i
i
i
i
i
i
i
i
i
i
"}
(31,1,1) = {"
i
i
i
i
i
i
i
i
i
i
K
K
M
n
D
M
K
K
i
i
i
i
i
i
i
i
i
i
i
i
i
i
i
i
i
"}
(32,1,1) = {"
i
i
i
i
i
i
i
i
i
i
K
K
M
n
D
M
K
K
i
i
i
i
i
i
i
i
i
i
i
i
i
i
i
i
i
"}
(33,1,1) = {"
i
i
i
i
i
i
i
i
i
i
K
K
M
n
D
M
K
K
i
i
i
i
i
i
i
i
i
i
i
i
i
i
i
i
i
"}
(34,1,1) = {"
i
i
i
i
i
i
i
i
i
i
K
K
M
n
D
M
K
K
i
i
i
i
i
i
i
i
i
i
i
i
i
i
i
i
i
"}
(35,1,1) = {"
K
K
K
K
K
K
K
K
K
K
K
K
M
n
D
M
K
K
i
i
i
i
i
i
i
i
i
i
i
i
i
i
i
i
i
"}
(36,1,1) = {"
K
K
K
K
K
K
K
K
K
K
K
K
M
n
D
M
K
K
i
i
i
i
i
i
i
i
i
i
i
i
i
i
i
i
i
"}
(37,1,1) = {"
S
S
S
S
S
S
S
S
S
S
S
S
M
n
q
M
K
K
i
i
i
i
i
i
i
i
i
i
i
i
i
i
i
i
i
"}
(38,1,1) = {"
M
M
M
M
M
M
M
M
M
M
M
M
M
n
D
M
K
K
i
i
i
i
i
i
i
i
i
i
i
i
i
i
i
i
i
"}
(39,1,1) = {"
M
y
J
J
J
J
J
J
J
J
J
J
J
G
D
M
K
K
i
i
i
i
i
i
i
i
i
i
i
i
i
i
i
i
i
"}
(40,1,1) = {"
M
h
p
b
b
b
b
b
l
b
b
b
b
b
g
M
K
K
i
i
i
i
i
i
i
i
i
i
i
i
i
i
i
i
i
"}
