//MAP CONVERTED BY dmm2tgm.py THIS HEADER COMMENT PREVENTS RECONVERSION, DO NOT REMOVE
"a" = (
/turf/open/space/basic,
/area/space)
"b" = (
/obj/machinery/button/door{
	dir = 4;
	id = "supplybridge";
	name = "Shuttle Bay Space Bridge Control";
	pixel_x = -22;
	pixel_y = -1
	},
/obj/machinery/door/airlock/external{
	name = "External Access";
	req_access_txt = "12"
	},
/turf/open/floor/plating,
/area/maintenance/port/aft)
"d" = (
/turf/open/floor/plating,
/area/maintenance/port)
"e" = (
/obj/structure/closet/emcloset,
/turf/open/floor/plating,
/area/maintenance/port/aft)
"g" = (
/obj/structure/fans/tiny/invisible,
/turf/open/space/basic,
/area/space/nearstation)
"j" = (
/turf/open/floor/plating{
	initial_gas_mix = "o2=0.01;n2=0.01;TEMP=2.7";
	luminosity = 2
	},
/area/maintenance/port)
"k" = (
/obj/structure/fans/tiny/invisible,
/turf/open/floor/fakespace,
/area/space/nearstation)
"n" = (
/turf/closed/wall,
/area/maintenance/port/aft)
"o" = (
/obj/machinery/button/door{
	dir = 4;
	id = "supplybridge";
	name = "Shuttle Bay Space Bridge Control";
	pixel_x = -22;
	pixel_y = -1
	},
/obj/machinery/door/airlock/external{
	name = "External Access";
	req_access_txt = "12"
	},
/turf/open/floor/plating,
/area/maintenance/port)
"q" = (
/obj/machinery/light/small{
	dir = 8
	},
/turf/open/floor/plating{
	initial_gas_mix = "o2=0.01;n2=0.01;TEMP=2.7";
	luminosity = 2
	},
/area/maintenance/port)
"r" = (
/obj/structure/fans/tiny/invisible,
/turf/open/floor/plating,
/area/space/nearstation)
"v" = (
/turf/open/floor/plating,
/area/space/nearstation)
"w" = (
/obj/structure/closet/firecloset,
/turf/open/floor/plating,
/area/maintenance/port/aft)
"y" = (
/turf/open/floor/plating{
	icon_state = "platingdmg3"
	},
/area/space/nearstation)
"A" = (
/obj/machinery/light/small{
	dir = 8
	},
/turf/open/floor/plating{
	icon_state = "platingdmg3"
	},
/area/maintenance/port/aft)
"B" = (
/obj/structure/sign/warning/vacuum/external{
	pixel_x = 32;
	pixel_y = 0
	},
/turf/open/floor/plating{
	initial_gas_mix = "o2=0.01;n2=0.01;TEMP=2.7";
	luminosity = 2
	},
/area/maintenance/port)
"C" = (
/obj/effect/decal/cleanable/oil{
	icon_state = "floor6"
	},
/turf/open/floor/plating,
/area/space/nearstation)
"E" = (
/obj/structure/closet/emcloset,
/turf/open/floor/plating,
/area/maintenance/port)
"I" = (
/obj/structure/closet/firecloset,
/turf/open/floor/plating,
/area/maintenance/port)
"J" = (
/obj/machinery/door/airlock/external{
	name = "External Access";
	req_access_txt = "12"
	},
/turf/open/floor/plating,
/area/maintenance/port/aft)
"L" = (
/turf/closed/wall,
/area/maintenance/port)
"M" = (
/obj/structure/sign/warning/vacuum/external{
	pixel_x = 32;
	pixel_y = 0
	},
/turf/open/floor/plating,
/area/maintenance/port/aft)
"P" = (
/obj/machinery/door/airlock/external{
	name = "External Access";
	req_access_txt = "12"
	},
/turf/open/floor/plating,
/area/maintenance/port)
"Q" = (
/turf/open/floor/fakespace,
/area/space/nearstation)
"R" = (
/turf/open/floor/plating,
/area/maintenance/port/aft)
"X" = (
/turf/open/floor/plating{
	icon_state = "platingdmg3"
	},
/area/maintenance/port/aft)

(1,1,1) = {"
L
L
L
a
a
a
a
a
a
a
a
a
a
a
a
n
n
n
"}
(2,1,1) = {"
L
I
L
r
k
k
k
k
k
k
k
k
k
k
r
n
w
n
"}
(3,1,1) = {"
q
d
o
y
C
Q
Q
Q
Q
Q
Q
Q
Q
Q
Q
b
X
A
"}
(4,1,1) = {"
B
j
P
v
v
Q
Q
Q
Q
Q
Q
Q
Q
Q
v
J
R
M
"}
(5,1,1) = {"
L
E
L
r
g
k
k
k
k
k
k
k
k
r
r
n
e
n
"}
(6,1,1) = {"
L
L
L
a
a
a
a
a
a
a
a
a
a
a
a
n
R
n
"}
