//MAP CONVERTED BY dmm2tgm.py THIS HEADER COMMENT PREVENTS RECONVERSION, DO NOT REMOVE
"a" = (
/turf/open/floor/grass/fakebasalt,
/area/maintenance/port)
"c" = (
/obj/structure/statue/boney{
	anchored = 1
	},
/turf/open/floor/grass/fakebasalt,
/area/maintenance/port/aft)
"d" = (
/obj/structure/statue/bone/rib{
	dir = 8
	},
/turf/open/floor/grass/fakebasalt,
/area/maintenance/port)
"e" = (
/obj/structure/closet/firecloset,
/turf/open/floor/grass/fakebasalt,
/area/maintenance/port)
"h" = (
/turf/closed/wall,
/area/maintenance/port)
"k" = (
/obj/structure/closet/firecloset,
/turf/open/floor/grass/fakebasalt,
/area/maintenance/port/aft)
"l" = (
/turf/closed/wall,
/area/maintenance/port/aft)
"m" = (
/obj/effect/spawner/lootdrop/lava_plush_danger_10,
/turf/open/floor/fakepit,
/area/maintenance/port)
"o" = (
/obj/structure/statue/boney{
	anchored = 1
	},
/turf/open/floor/grass/fakebasalt,
/area/maintenance/port)
"p" = (
/obj/structure/fans/tiny,
/obj/machinery/door/poddoor/shutters{
	id = "supplybridge"
	},
/turf/open/floor/plating,
/area/maintenance/port)
"q" = (
/obj/structure/deployable_barricade/wooden,
/turf/open/floor/grass/fakebasalt,
/area/maintenance/port/aft)
"t" = (
/obj/structure/deployable_barricade/wooden{
	dir = 4
	},
/turf/open/floor/grass/fakebasalt,
/area/maintenance/port/aft)
"v" = (
/obj/structure/mineral_door/wood,
/turf/open/floor/grass/fakebasalt,
/area/maintenance/port)
"x" = (
/turf/open/floor/fakepit,
/area/maintenance/port)
"A" = (
/obj/machinery/button/door{
	dir = 4;
	id = "supplybridge";
	name = "Shuttle Bay Space Bridge Control";
	pixel_x = -22;
	pixel_y = -1
	},
/obj/structure/mineral_door/wood,
/turf/open/floor/grass/fakebasalt,
/area/maintenance/port)
"B" = (
/obj/structure/deployable_barricade/wooden{
	dir = 1
	},
/turf/open/floor/grass/fakebasalt,
/area/maintenance/port)
"C" = (
/obj/structure/closet/emcloset,
/turf/open/floor/grass/fakebasalt,
/area/maintenance/port)
"G" = (
/obj/machinery/light/small{
	dir = 8
	},
/obj/structure/deployable_barricade/wooden,
/turf/open/floor/grass/fakebasalt,
/area/maintenance/port/aft)
"H" = (
/obj/structure/statue/boney/ashwalker{
	anchored = 1
	},
/turf/open/floor/grass/fakebasalt,
/area/maintenance/port)
"I" = (
/obj/structure/statue/bone/skull/half,
/turf/open/floor/grass/fakebasalt,
/area/maintenance/port)
"N" = (
/obj/effect/spawner/lootdrop/lava_plush_danger_10,
/turf/open/floor/grass/fakebasalt,
/area/maintenance/port)
"P" = (
/obj/structure/statue/bone/skull/half{
	dir = 8
	},
/turf/open/floor/grass/fakebasalt,
/area/maintenance/port)
"T" = (
/obj/machinery/light/small{
	dir = 8
	},
/obj/structure/deployable_barricade/wooden{
	dir = 1
	},
/turf/open/floor/grass/fakebasalt,
/area/maintenance/port)
"W" = (
/turf/open/floor/plating,
/area/maintenance/port/aft)
"Y" = (
/obj/structure/statue/boney/ashwalker{
	anchored = 1
	},
/turf/open/floor/grass/fakebasalt,
/area/maintenance/port/aft)
"Z" = (
/obj/structure/statue/bone/rib,
/turf/open/floor/grass/fakebasalt,
/area/maintenance/port)

(1,1,1) = {"
h
h
h
p
p
p
p
p
p
p
p
p
p
p
p
h
l
l
"}
(2,1,1) = {"
h
e
h
I
a
d
a
d
x
d
a
d
a
d
a
h
k
l
"}
(3,1,1) = {"
T
o
A
a
N
x
x
x
x
a
a
N
a
a
a
A
Y
G
"}
(4,1,1) = {"
B
H
v
a
a
a
a
N
a
a
a
x
x
m
a
v
c
q
"}
(5,1,1) = {"
h
C
h
P
a
Z
a
Z
a
Z
a
Z
x
Z
a
h
t
l
"}
(6,1,1) = {"
h
h
h
p
p
p
p
p
p
p
p
p
p
p
p
h
W
l
"}
