//MAP CONVERTED BY dmm2tgm.py THIS HEADER COMMENT PREVENTS RECONVERSION, DO NOT REMOVE
"a" = (
/turf/template_noop,
/area/template_noop)
"b" = (
/turf/closed/wall/r_wall,
/area/ruin/space/has_grav/powered/advancedlab)
"c" = (
/obj/machinery/light/small,
/obj/effect/decal/cleanable/dirt/dust,
/turf/open/floor/wood,
/area/ruin/space/has_grav/powered/advancedlab)
"d" = (
/obj/structure/tank_dispenser/oxygen,
/obj/effect/decal/cleanable/cobweb,
/turf/open/floor/wood,
/area/ruin/space/has_grav/powered/advancedlab)
"e" = (
/obj/machinery/vending/snack/random,
/turf/open/floor/wood,
/area/ruin/space/has_grav/powered/advancedlab)
"f" = (
/obj/structure/showcase/horrific_experiment,
/turf/open/floor/plating/abductor,
/area/ruin/space/has_grav/powered/advancedlab)
"g" = (
/obj/structure/reagent_dispensers/water_cooler,
/turf/open/floor/wood,
/area/ruin/space/has_grav/powered/advancedlab)
"h" = (
/obj/structure/table/glass,
/obj/item/multitool/advanced{
	pixel_x = 4;
	pixel_y = -1
	},
/obj/item/crowbar/advanced{
	pixel_x = 1;
	pixel_y = 1
	},
/obj/item/wrench/advanced{
	pixel_x = -5;
	pixel_y = 0
	},
/turf/open/floor/plating/abductor,
/area/ruin/space/has_grav/powered/advancedlab)
"i" = (
/obj/structure/salvage/computer,
/turf/open/floor/plating/abductor,
/area/ruin/space/has_grav/powered/advancedlab)
"j" = (
/obj/machinery/light/small{
	dir = 1;
	icon_state = "bulb"
	},
/obj/item/kirbyplants{
	icon_state = "plant-21"
	},
/turf/open/floor/wood,
/area/ruin/space/has_grav/powered/advancedlab)
"k" = (
/turf/open/floor/plating/abductor,
/area/ruin/space/has_grav/powered/advancedlab)
"l" = (
/obj/structure/chair/comfy/beige,
/turf/open/floor/wood,
/area/ruin/space/has_grav/powered/advancedlab)
"m" = (
/obj/structure/table/glass,
/obj/item/paper{
	default_raw_text = "As of yet, our experiments have seen a fair bit of success. Unfortunately, our business partners have stopped funding us as they realised they utterly hate each other. To whoever finds this place, they are yours. Use them how you will. I leave you with the next generation of greytiding.";
	name = "Note to finder";
	pixel_x = -1;
	pixel_y = 3
	},
/obj/structure/noticeboard{
	pixel_y = 32
	},
/obj/item/paper/guides/antag/abductor{
	pixel_x = 8;
	pixel_y = 3
	},
/turf/open/floor/plating/abductor,
/area/ruin/space/has_grav/powered/advancedlab)
"n" = (
/obj/machinery/door/airlock/external/abandoned_gray,
/turf/open/floor/plating/abductor,
/area/ruin/space/has_grav/powered/advancedlab)
"o" = (
/obj/structure/fans/tiny,
/obj/machinery/door/airlock/external,
/turf/open/floor/wood,
/area/ruin/space/has_grav/powered/advancedlab)
"p" = (
/obj/structure/filingcabinet/chestdrawer,
/obj/structure/extinguisher_cabinet{
	pixel_x = 0;
	pixel_y = 31
	},
/turf/open/floor/plating/abductor,
/area/ruin/space/has_grav/powered/advancedlab)
"q" = (
/obj/structure/closet,
/obj/item/clothing/suit/hooded/wintercoat/miner,
/obj/item/clothing/shoes/sneakers/brown,
/obj/item/clothing/under/pants/classicjeans,
/obj/item/clothing/neck/scarf,
/obj/item/clothing/neck/stripedgreenscarf,
/obj/item/toy/fluff/tennis_poly/tri/squeak/rainbow,
/obj/item/toy/fluff/tennis_poly,
/obj/item/clothing/suit/hooded/wintercoat/miner,
/obj/item/clothing/shoes/sneakers/brown,
/obj/item/clothing/under/pants/classicjeans,
/obj/effect/decal/cleanable/dirt/dust,
/turf/open/floor/wood,
/area/ruin/space/has_grav/powered/advancedlab)
"r" = (
/obj/structure/table/glass,
/obj/item/gps{
	gpstag = "Abductor Replication Lab";
	pixel_x = -6;
	pixel_y = 7
	},
/turf/open/floor/wood,
/area/ruin/space/has_grav/powered/advancedlab)
"s" = (
/obj/structure/table/glass,
/obj/item/reagent_containers/glass/coffeepot/bluespace{
	pixel_x = 5;
	pixel_y = 9
	},
/obj/item/reagent_containers/food/drinks/coffee{
	pixel_x = -7;
	pixel_y = 7
	},
/turf/open/floor/wood,
/area/ruin/space/has_grav/powered/advancedlab)
"t" = (
/obj/machinery/light/small,
/obj/structure/salvage/computer{
	dir = 1
	},
/turf/open/floor/plating/abductor,
/area/ruin/space/has_grav/powered/advancedlab)
"u" = (
/obj/effect/decal/cleanable/dirt/dust,
/turf/open/floor/wood,
/area/ruin/space/has_grav/powered/advancedlab)
"v" = (
/obj/machinery/vending/boozeomat{
	req_access = null;
	shut_up = 1
	},
/turf/closed/wall,
/area/ruin/space/has_grav/powered/advancedlab)
"w" = (
/obj/machinery/photocopier,
/turf/open/floor/plating/abductor,
/area/ruin/space/has_grav/powered/advancedlab)
"x" = (
/obj/machinery/light{
	dir = 4
	},
/turf/open/floor/plating/abductor,
/area/ruin/space/has_grav/powered/advancedlab)
"y" = (
/obj/machinery/light/small{
	dir = 1;
	icon_state = "bulb"
	},
/obj/effect/decal/cleanable/cobweb,
/obj/effect/decal/cleanable/dirt/dust,
/turf/open/floor/wood,
/area/ruin/space/has_grav/powered/advancedlab)
"z" = (
/obj/machinery/door/airlock/security{
	name = "Visiting Business Partners"
	},
/turf/open/floor/wood,
/area/ruin/space/has_grav/powered/advancedlab)
"A" = (
/turf/open/floor/wood,
/area/ruin/space/has_grav/powered/advancedlab)
"B" = (
/obj/structure/bed,
/obj/item/bedsheet/syndie,
/obj/effect/decal/cleanable/dirt/dust,
/turf/open/floor/wood,
/area/ruin/space/has_grav/powered/advancedlab)
"C" = (
/obj/structure/closet{
	name = "Clothes"
	},
/obj/item/clothing/head/chameleon,
/obj/item/clothing/gloves/tackler/combat/insulated,
/obj/item/clothing/suit/chameleon,
/obj/item/clothing/under/chameleon,
/obj/item/clothing/shoes/chameleon,
/obj/effect/decal/cleanable/dirt/dust,
/turf/open/floor/wood,
/area/ruin/space/has_grav/powered/advancedlab)
"D" = (
/obj/machinery/light/small,
/turf/open/floor/wood,
/area/ruin/space/has_grav/powered/advancedlab)
"E" = (
/obj/structure/table/wood,
/obj/item/radio/headset/chameleon,
/obj/effect/decal/cleanable/dirt/dust,
/turf/open/floor/wood,
/area/ruin/space/has_grav/powered/advancedlab)
"F" = (
/obj/structure/falsewall/reinforced,
/turf/open/floor/wood,
/area/ruin/space/has_grav/powered/advancedlab)
"G" = (
/obj/structure/table/wood,
/turf/open/floor/wood,
/area/ruin/space/has_grav/powered/advancedlab)
"H" = (
/obj/structure/table/wood,
/obj/item/radio/headset/headset_cent/alt{
	keyslot2 = null
	},
/turf/open/floor/wood,
/area/ruin/space/has_grav/powered/advancedlab)
"I" = (
/obj/structure/closet{
	name = "Official Clothing"
	},
/obj/item/clothing/under/rank/centcom/commander,
/obj/item/clothing/head/centhat,
/obj/item/clothing/gloves/tackler/combat/insulated,
/obj/item/clothing/suit/armor/vest,
/obj/item/clothing/shoes/sneakers/brown,
/obj/effect/decal/cleanable/cobweb/cobweb2,
/turf/open/floor/wood,
/area/ruin/space/has_grav/powered/advancedlab)
"J" = (
/obj/machinery/door/airlock/command{
	name = "Dorms"
	},
/turf/open/floor/wood,
/area/ruin/space/has_grav/powered/advancedlab)
"K" = (
/obj/machinery/door/airlock/command{
	name = "Visiting Officials"
	},
/turf/open/floor/wood,
/area/ruin/space/has_grav/powered/advancedlab)
"L" = (
/obj/structure/bed,
/obj/item/bedsheet/centcom,
/turf/open/floor/wood,
/area/ruin/space/has_grav/powered/advancedlab)
"M" = (
/obj/structure/lattice,
/obj/effect/spawner/structure/window/reinforced,
/turf/open/space/basic,
/area/ruin/space/has_grav/powered/advancedlab)
"N" = (
/turf/closed/wall/mineral/abductor,
/area/ruin/space/has_grav/powered/advancedlab)
"O" = (
/obj/structure/chair/comfy/beige{
	dir = 1;
	icon_state = "comfychair"
	},
/turf/open/floor/wood,
/area/ruin/space/has_grav/powered/advancedlab)
"P" = (
/obj/structure/lattice,
/turf/template_noop,
/area/space/nearstation)
"Q" = (
/obj/effect/spawner/lootdrop/salvage,
/turf/open/floor/wood,
/area/ruin/space/has_grav/powered/advancedlab)
"R" = (
/obj/structure/salvage/computer{
	dir = 1
	},
/turf/open/floor/plating/abductor,
/area/ruin/space/has_grav/powered/advancedlab)
"S" = (
/obj/structure/table/glass,
/obj/item/wirecutters/advanced{
	pixel_y = 7
	},
/obj/item/screwdriver/advanced{
	pixel_y = -3;
	pixel_x = 0
	},
/obj/item/weldingtool/advanced{
	pixel_x = -4;
	pixel_y = -2
	},
/turf/open/floor/plating/abductor,
/area/ruin/space/has_grav/powered/advancedlab)
"T" = (
/obj/machinery/light/small{
	dir = 4
	},
/turf/open/floor/wood,
/area/ruin/space/has_grav/powered/advancedlab)
"Z" = (
/obj/machinery/vending/assist,
/obj/effect/decal/cleanable/dirt/dust,
/turf/open/floor/wood,
/area/ruin/space/has_grav/powered/advancedlab)

(1,1,1) = {"
a
b
b
b
b
b
b
b
b
a
a
a
a
a
a
a
a
a
"}
(2,1,1) = {"
P
b
d
A
A
l
r
O
b
P
a
a
a
a
a
a
a
a
"}
(3,1,1) = {"
b
b
b
j
A
l
s
O
b
P
P
a
P
P
a
a
a
a
"}
(4,1,1) = {"
o
A
o
A
A
A
A
A
b
M
M
M
M
M
P
a
a
a
"}
(5,1,1) = {"
b
b
b
j
A
A
A
A
J
u
T
A
A
M
P
a
a
a
"}
(6,1,1) = {"
P
b
e
A
A
A
A
u
b
M
M
M
A
M
a
a
a
a
"}
(7,1,1) = {"
P
b
g
A
A
Q
Z
q
b
P
P
M
A
M
P
a
a
a
"}
(8,1,1) = {"
P
N
N
N
n
N
N
N
b
P
P
M
A
M
P
P
a
a
"}
(9,1,1) = {"
a
N
S
k
k
k
R
N
b
b
b
b
J
b
b
P
a
a
"}
(10,1,1) = {"
a
N
h
k
k
k
f
N
y
A
u
F
T
u
b
P
a
a
"}
(11,1,1) = {"
a
N
i
k
k
k
t
N
z
v
b
b
b
K
b
a
a
a
"}
(12,1,1) = {"
a
N
p
k
k
k
f
N
A
C
b
G
A
A
b
a
a
a
"}
(13,1,1) = {"
a
N
m
k
x
k
w
N
A
c
b
H
A
D
b
P
a
a
"}
(14,1,1) = {"
a
N
N
N
N
N
N
N
B
E
b
I
A
L
b
P
a
a
"}
(15,1,1) = {"
a
a
a
a
P
P
P
b
b
b
b
b
b
b
b
P
a
a
"}
