//MAP CONVERTED BY dmm2tgm.py THIS HEADER COMMENT PREVENTS RECONVERSION, DO NOT REMOVE
"a" = (
/turf/template_noop,
/area/template_noop)
"b" = (
/turf/closed/wall/mineral/plastitanium{
	dir = 8;
	icon_state = "diagonalWall3"
	},
/area/ruin/space/has_grav/powered/authorship)
"c" = (
/turf/closed/wall/mineral/plastitanium,
/area/ruin/space/has_grav/powered/authorship)
"d" = (
/turf/closed/wall/mineral/plastitanium{
	dir = 1;
	icon_state = "diagonalWall3"
	},
/area/ruin/space/has_grav/powered/authorship)
"e" = (
/obj/structure/shuttle/engine/propulsion{
	dir = 8
	},
/turf/template_noop,
/area/ruin/space/has_grav/powered/authorship)
"f" = (
/obj/structure/window/reinforced{
	dir = 4
	},
/obj/structure/shuttle/engine/heater{
	dir = 8
	},
/turf/open/floor/plating/airless,
/area/ruin/space/has_grav/powered/authorship)
"g" = (
/obj/item/kirbyplants/photosynthetic,
/turf/open/floor/mineral/titanium/purple,
/area/ruin/space/has_grav/powered/authorship)
"h" = (
/turf/open/floor/mineral/titanium/purple,
/area/ruin/space/has_grav/powered/authorship)
"i" = (
/obj/machinery/light{
	dir = 1
	},
/turf/open/floor/mineral/titanium/purple,
/area/ruin/space/has_grav/powered/authorship)
"j" = (
/obj/structure/closet,
/turf/open/floor/mineral/titanium/purple,
/area/ruin/space/has_grav/powered/authorship)
"k" = (
/obj/machinery/vending/assist,
/turf/open/floor/mineral/titanium/purple,
/area/ruin/space/has_grav/powered/authorship)
"l" = (
/obj/machinery/vending/autodrobe/all_access,
/turf/open/floor/mineral/titanium/purple,
/area/ruin/space/has_grav/powered/authorship)
"m" = (
/obj/machinery/light{
	dir = 8
	},
/turf/open/floor/mineral/titanium/purple,
/area/ruin/space/has_grav/powered/authorship)
"n" = (
/obj/structure/table/wood,
/obj/item/paper,
/obj/item/pen{
	pixel_x = 5;
	pixel_y = 3
	},
/obj/item/gps{
	gpstag = "librattle";
	pixel_x = -10;
	pixel_y = 7
	},
/turf/open/floor/mineral/titanium/purple,
/area/ruin/space/has_grav/powered/authorship)
"o" = (
/obj/structure/table/wood,
/obj/machinery/computer/library/checkout,
/turf/open/floor/mineral/titanium/purple,
/area/ruin/space/has_grav/powered/authorship)
"p" = (
/obj/effect/spawner/structure/window/reinforced,
/turf/open/floor/plating,
/area/ruin/space/has_grav/powered/authorship)
"r" = (
/obj/structure/table/wood,
/obj/item/paper_bin,
/obj/item/pen,
/turf/open/floor/mineral/titanium/purple,
/area/ruin/space/has_grav/powered/authorship)
"s" = (
/obj/machinery/door/poddoor{
	id = "goonwizship1"
	},
/obj/machinery/button/door{
	id = "goonwizship1";
	name = "Strange Ship Door Button";
	pixel_y = 32
	},
/obj/structure/fans/tiny,
/turf/open/floor/mineral/titanium/purple,
/area/ruin/space/has_grav/powered/authorship)
"t" = (
/obj/machinery/door/airlock/external,
/obj/structure/fans/tiny,
/turf/open/floor/mineral/titanium/purple,
/area/ruin/space/has_grav/powered/authorship)
"u" = (
/obj/machinery/door/airlock/public/glass,
/turf/open/floor/mineral/titanium/purple,
/area/ruin/space/has_grav/powered/authorship)
"v" = (
/obj/structure/chair/comfy/shuttle{
	dir = 4
	},
/turf/open/floor/mineral/titanium/purple,
/area/ruin/space/has_grav/powered/authorship)
"w" = (
/obj/structure/frame/computer{
	dir = 8
	},
/turf/open/floor/mineral/titanium/purple,
/area/ruin/space/has_grav/powered/authorship)
"x" = (
/obj/machinery/light,
/obj/machinery/suit_storage_unit/open,
/turf/open/floor/mineral/titanium/purple,
/area/ruin/space/has_grav/powered/authorship)
"y" = (
/mob/living/simple_animal/bot/medbot,
/turf/open/floor/mineral/titanium/purple,
/area/ruin/space/has_grav/powered/authorship)
"z" = (
/turf/closed/wall/mineral/plastitanium{
	icon_state = "diagonalWall3"
	},
/area/ruin/space/has_grav/powered/authorship)
"A" = (
/obj/structure/chair,
/turf/open/floor/mineral/titanium/purple,
/area/ruin/space/has_grav/powered/authorship)
"B" = (
/turf/closed/wall/mineral/plastitanium{
	dir = 4;
	icon_state = "diagonalWall3"
	},
/area/ruin/space/has_grav/powered/authorship)
"C" = (
/obj/machinery/light,
/obj/structure/bed,
/obj/effect/spawner/lootdrop/bedsheet,
/turf/open/floor/mineral/titanium/purple,
/area/ruin/space/has_grav/powered/authorship)
"E" = (
/obj/structure/tank_dispenser/oxygen,
/turf/open/floor/mineral/titanium/purple,
/area/ruin/space/has_grav/powered/authorship)
"G" = (
/obj/machinery/light{
	dir = 8
	},
/obj/item/kirbyplants/random,
/turf/open/floor/mineral/titanium/purple,
/area/ruin/space/has_grav/powered/authorship)
"H" = (
/obj/structure/bookcase/random,
/turf/open/floor/mineral/titanium/purple,
/area/ruin/space/has_grav/powered/authorship)
"Q" = (
/obj/item/circuitboard/computer/shuttle/docker,
/obj/item/circuitboard/computer/shuttle/flight_control,
/obj/item/circuitboard/machine/shuttle/heater,
/obj/item/circuitboard/machine/shuttle/engine/plasma,
/obj/item/shuttle_creator,
/obj/item/circuitboard/machine/shuttle/engine/plasma,
/obj/item/circuitboard/machine/shuttle/heater,
/obj/item/pipe_dispenser,
/obj/structure/table/wood,
/turf/open/floor/mineral/titanium/purple,
/area/ruin/space/has_grav/powered/authorship)
"U" = (
/obj/structure/closet,
/obj/item/clothing/under/shorts/black,
/obj/item/clothing/shoes/sandal,
/turf/open/floor/mineral/titanium/purple,
/area/ruin/space/has_grav/powered/authorship)
"X" = (
/obj/structure/table/wood,
/obj/item/clothing/glasses/welding,
/turf/open/floor/mineral/titanium/purple,
/area/ruin/space/has_grav/powered/authorship)
"Y" = (
/obj/structure/table/wood,
/obj/item/book_of_babel{
	pixel_x = 6;
	pixel_y = -1
	},
/obj/item/pen{
	pixel_x = 9;
	pixel_y = 9
	},
/obj/item/flashlight/lamp{
	pixel_x = -8;
	pixel_y = 3
	},
/turf/open/floor/mineral/titanium/purple,
/area/ruin/space/has_grav/powered/authorship)

(1,1,1) = {"
a
a
a
b
c
s
c
z
a
a
a
"}
(2,1,1) = {"
a
e
e
c
X
h
Q
c
e
e
a
"}
(3,1,1) = {"
b
f
f
c
E
h
x
c
f
f
z
"}
(4,1,1) = {"
c
k
l
c
p
t
p
c
A
Y
c
"}
(5,1,1) = {"
c
h
h
c
g
h
g
c
h
o
c
"}
(6,1,1) = {"
c
i
h
m
h
h
h
m
h
C
c
"}
(7,1,1) = {"
c
h
h
h
h
h
h
h
h
U
c
"}
(8,1,1) = {"
c
H
H
H
h
h
h
H
H
H
c
"}
(9,1,1) = {"
d
c
c
c
p
u
p
c
c
c
B
"}
(10,1,1) = {"
a
a
c
G
h
h
h
G
c
a
a
"}
(11,1,1) = {"
a
a
p
h
y
v
h
h
p
a
a
"}
(12,1,1) = {"
a
a
c
j
r
w
n
j
c
a
a
"}
(13,1,1) = {"
a
a
d
c
p
p
p
c
B
a
a
"}
