//MAP CONVERTED BY dmm2tgm.py THIS HEADER COMMENT PREVENTS RECONVERSION, DO NOT REMOVE
"a" = (
/turf/template_noop,
/area/template_noop)
"b" = (
/turf/open/floor/mineral/titanium/white/airless,
/area/ruin/space/has_grav)
"c" = (
/turf/closed/wall/mineral/titanium,
/area/ruin/space/has_grav)
"d" = (
/obj/structure/alien/resin/wall{
	color = "#8EC127";
	desc = "Thick material shaped into a wall. Eugh.";
	icon_state = "smooth";
	name = "gelatinous wall"
	},
/turf/template_noop,
/area/ruin/space/has_grav)
"e" = (
/obj/structure/shuttle/engine/propulsion,
/turf/open/space/basic,
/area/ruin/space/has_grav)
"f" = (
/obj/machinery/door/airlock/shuttle,
/turf/open/floor/mineral/titanium/white/airless,
/area/ruin/space/has_grav)
"g" = (
/obj/structure/chair/comfy/shuttle{
	dir = 8
	},
/turf/open/floor/mineral/titanium/white/airless,
/area/ruin/space/has_grav)
"h" = (
/obj/machinery/computer,
/turf/open/floor/mineral/titanium/white/airless,
/area/ruin/space/has_grav)
"i" = (
/obj/structure/alien/resin/membrane{
	color = "#4BAE56";
	desc = "A strange combination of thin, gelatinous material.";
	icon_state = "smooth";
	name = "gelatinous membrane"
	},
/turf/template_noop,
/area/ruin/space/has_grav)
"j" = (
/obj/structure/chair/comfy/shuttle{
	dir = 4
	},
/obj/effect/mob_spawn/human/corpse/assistant,
/turf/open/floor/mineral/titanium/white/airless,
/area/ruin/space/has_grav)
"k" = (
/obj/structure/chair/comfy/shuttle{
	dir = 4
	},
/obj/item/storage/pod{
	pixel_x = -32
	},
/turf/open/floor/mineral/titanium/white/airless,
/area/ruin/space/has_grav)
"l" = (
/obj/structure/chair/comfy/shuttle{
	dir = 8
	},
/obj/item/storage/pod{
	pixel_x = 32
	},
/turf/open/floor/mineral/titanium/white/airless,
/area/ruin/space/has_grav)
"m" = (
/obj/item/gps{
	gpstag = "SOS"
	},
/turf/open/floor/mineral/titanium/white/airless,
/area/ruin/space/has_grav)
"n" = (
/obj/structure/chair/comfy/shuttle{
	dir = 1
	},
/obj/effect/mob_spawn/human/corpse/cargo_tech,
/turf/open/floor/mineral/titanium/white/airless,
/area/ruin/space/has_grav)
"o" = (
/obj/structure/alien/weeds{
	color = "#4BAE56";
	desc = "A thick gelatinous surface covers the floor.  Someone get the golashes.";
	name = "gelatinous floor"
	},
/obj/structure/grille/broken,
/mob/living/simple_animal/hostile/netherworld{
	name = "human?";
	desc = "Something that was once human..."
	},
/turf/open/floor/mineral/titanium/white/airless,
/area/ruin/space/has_grav)
"p" = (
/obj/structure/alien/weeds{
	color = "#4BAE56";
	desc = "A thick gelatinous surface covers the floor.  Someone get the golashes.";
	name = "gelatinous floor"
	},
/obj/structure/grille,
/turf/open/floor/mineral/titanium/white/airless,
/area/ruin/space/has_grav)
"q" = (
/obj/structure/chair/comfy/shuttle{
	dir = 4
	},
/obj/structure/alien/weeds{
	color = "#4BAE56";
	desc = "A thick gelatinous surface covers the floor.  Someone get the golashes.";
	name = "gelatinous floor"
	},
/turf/open/floor/mineral/titanium/white/airless,
/area/ruin/space/has_grav)

(1,1,1) = {"
a
a
a
d
d
d
a
a
a
a
a
a
"}
(2,1,1) = {"
a
a
a
d
c
c
c
c
c
e
a
a
"}
(3,1,1) = {"
a
a
d
d
p
q
q
j
k
c
a
a
"}
(4,1,1) = {"
a
a
i
i
o
b
b
m
b
f
a
a
"}
(5,1,1) = {"
a
a
i
i
p
h
n
g
l
c
a
a
"}
(6,1,1) = {"
a
a
i
d
c
c
c
c
c
e
a
a
"}
(7,1,1) = {"
a
a
a
d
d
a
a
a
a
a
a
a
"}
(8,1,1) = {"
a
a
a
a
a
a
a
a
a
a
a
a
"}
