//MAP CONVERTED BY dmm2tgm.py THIS HEADER COMMENT PREVENTS RECONVERSION, DO NOT REMOVE
"a" = (
/turf/template_noop,
/area/space)
"b" = (
/turf/closed/wall/r_wall,
/area/ruin/space/has_grav/powered)
"c" = (
/obj/structure/rack,
/obj/item/stack/sheet/glass/fifty,
/obj/item/stack/sheet/glass/fifty,
/obj/item/stack/sheet/glass/fifty,
/turf/open/floor/plasteel,
/area/ruin/space/has_grav/powered)
"d" = (
/turf/open/floor/plasteel/airless,
/area/ruin/space/has_grav/powered)
"e" = (
/obj/machinery/portable_atmospherics/canister/air,
/turf/open/floor/plasteel,
/area/ruin/space/has_grav/powered)
"f" = (
/obj/structure/rack,
/obj/item/stack/sheet/metal/fifty,
/obj/item/stack/sheet/metal/fifty,
/obj/item/stack/sheet/metal/fifty,
/obj/item/stack/cable_coil,
/obj/item/stack/cable_coil,
/turf/open/floor/plasteel,
/area/ruin/space/has_grav/powered)
"g" = (
/obj/machinery/portable_atmospherics/canister/toxins,
/turf/open/floor/plasteel/airless,
/area/ruin/space/has_grav/powered)
"h" = (
/obj/structure/closet/crate/science,
/obj/item/circuitboard/computer/shuttle/docker,
/obj/item/circuitboard/computer/shuttle/flight_control,
/obj/item/circuitboard/machine/shuttle/heater,
/obj/item/circuitboard/machine/shuttle/engine/plasma,
/obj/item/shuttle_creator,
/obj/item/circuitboard/machine/shuttle/engine/plasma,
/obj/item/circuitboard/machine/shuttle/heater,
/obj/item/pipe_dispenser,
/turf/open/floor/plasteel,
/area/ruin/space/has_grav/powered)
"i" = (
/obj/machinery/door/airlock/external/glass,
/obj/structure/fans/tiny,
/turf/open/floor/plasteel,
/area/ruin/space/has_grav/powered)
"j" = (
/obj/structure/lattice,
/turf/template_noop,
/area/space)
"k" = (
/turf/open/floor/plasteel/yellowsiding,
/area/ruin/space/has_grav/powered)
"l" = (
/turf/open/floor/plasteel/yellowsiding{
	dir = 1
	},
/area/ruin/space/has_grav/powered)
"m" = (
/obj/structure/rack,
/obj/item/stack/rods,
/obj/item/stack/rods,
/turf/open/floor/plasteel,
/area/ruin/space/has_grav/powered)
"n" = (
/obj/structure/table,
/obj/item/storage/toolbox/mechanical,
/turf/open/floor/plasteel,
/area/ruin/space/has_grav/powered)
"o" = (
/obj/structure/table,
/obj/item/stack/cable_coil/random,
/obj/item/stack/cable_coil/random,
/obj/item/stack/cable_coil/random,
/obj/item/storage/toolbox/electrical,
/turf/open/floor/plasteel,
/area/ruin/space/has_grav/powered)
"p" = (
/turf/open/floor/plating,
/area/space)
"q" = (
/obj/structure/girder/displaced,
/turf/open/floor/plating,
/area/space)
"r" = (
/obj/structure/fans/tiny,
/turf/open/floor/plating,
/area/space)
"s" = (
/obj/structure/statue/gold/ce,
/turf/open/floor/plasteel,
/area/ruin/space/has_grav/powered)
"u" = (
/obj/effect/decal/cleanable/oil,
/turf/open/floor/plasteel,
/area/ruin/space/has_grav/powered)
"y" = (
/obj/structure/rack,
/obj/item/stack/cable_coil,
/turf/open/floor/plasteel/airless,
/area/ruin/space/has_grav/powered)
"z" = (
/obj/effect/decal/cleanable/oil,
/turf/open/floor/plasteel/yellowsiding{
	dir = 1
	},
/area/ruin/space/has_grav/powered)
"D" = (
/obj/effect/decal/cleanable/oil,
/turf/open/floor/plasteel/yellowsiding,
/area/ruin/space/has_grav/powered)
"E" = (
/obj/machinery/portable_atmospherics/canister/toxins,
/turf/open/floor/plasteel,
/area/ruin/space/has_grav/powered)
"F" = (
/obj/structure/frame/machine,
/turf/open/floor/plasteel/airless,
/area/ruin/space/has_grav/powered)
"J" = (
/obj/structure/girder/displaced,
/turf/open/floor/plasteel/airless,
/area/ruin/space/has_grav/powered)
"N" = (
/turf/open/floor/plasteel,
/area/ruin/space/has_grav/powered)
"O" = (
/obj/structure/table,
/obj/item/wrench/caravan,
/turf/open/floor/plasteel/airless,
/area/ruin/space/has_grav/powered)
"P" = (
/obj/effect/decal/cleanable/oil{
	icon_state = "floor6"
	},
/turf/open/floor/plasteel/airless,
/area/ruin/space/has_grav/powered)
"S" = (
/obj/effect/decal/cleanable/oil,
/obj/structure/frame/machine,
/turf/open/floor/plasteel/airless,
/area/ruin/space/has_grav/powered)
"T" = (
/obj/structure/frame/computer{
	anchored = 1
	},
/turf/open/floor/plasteel/airless,
/area/ruin/space/has_grav/powered)
"U" = (
/obj/machinery/portable_atmospherics/canister/air,
/turf/open/floor/plasteel/airless,
/area/ruin/space/has_grav/powered)
"Y" = (
/obj/structure/table,
/turf/open/floor/plasteel/airless,
/area/ruin/space/has_grav/powered)
"Z" = (
/obj/structure/table,
/obj/item/stack/cable_coil,
/turf/open/floor/plasteel/yellowsiding{
	dir = 1
	},
/area/ruin/space/has_grav/powered)

(1,1,1) = {"
a
a
a
a
a
a
a
a
a
a
a
a
a
a
a
a
a
a
"}
(2,1,1) = {"
a
a
a
a
a
a
a
a
a
a
a
a
a
a
a
a
a
a
"}
(3,1,1) = {"
a
a
a
a
a
a
a
a
a
a
a
a
a
a
a
a
a
a
"}
(4,1,1) = {"
a
a
a
a
a
a
a
a
a
a
a
a
a
a
a
a
a
a
"}
(5,1,1) = {"
a
a
a
a
a
a
a
a
a
a
a
a
a
a
a
a
a
a
"}
(6,1,1) = {"
a
a
a
a
a
a
j
a
a
a
a
a
a
a
a
j
a
a
"}
(7,1,1) = {"
a
a
a
a
a
a
j
a
a
a
a
a
a
a
a
j
a
a
"}
(8,1,1) = {"
a
a
a
a
a
U
k
a
a
a
a
a
a
a
a
l
d
a
"}
(9,1,1) = {"
a
a
a
a
b
g
k
j
j
j
j
j
j
j
j
l
d
b
"}
(10,1,1) = {"
a
a
a
a
a
g
D
a
a
a
a
a
a
a
a
l
d
a
"}
(11,1,1) = {"
b
b
b
b
b
b
k
a
q
p
p
p
p
q
a
l
d
a
"}
(12,1,1) = {"
b
c
f
m
h
b
k
a
q
p
p
p
p
q
a
l
S
a
"}
(13,1,1) = {"
b
N
N
N
N
b
k
a
r
p
p
p
p
q
a
l
F
a
"}
(14,1,1) = {"
b
s
N
u
N
i
k
a
q
p
p
p
p
q
a
l
T
a
"}
(15,1,1) = {"
b
N
N
N
N
b
k
a
q
p
p
p
p
q
a
l
T
a
"}
(16,1,1) = {"
b
e
E
n
o
b
k
a
q
q
p
p
q
q
a
l
P
a
"}
(17,1,1) = {"
b
b
b
b
b
b
k
a
a
r
p
p
q
a
a
z
y
a
"}
(18,1,1) = {"
a
a
a
a
a
J
k
a
a
q
p
p
q
a
a
l
O
a
"}
(19,1,1) = {"
a
a
a
a
a
J
D
a
a
q
q
q
q
a
a
z
Y
a
"}
(20,1,1) = {"
a
a
a
a
a
J
k
a
a
a
a
a
a
a
a
Z
Y
a
"}
(21,1,1) = {"
a
a
a
a
b
J
k
j
j
j
j
j
j
j
j
l
d
b
"}
(22,1,1) = {"
a
a
a
a
a
d
k
a
a
a
a
a
a
a
a
l
d
a
"}
(23,1,1) = {"
a
a
a
a
a
a
j
a
a
a
a
a
a
a
a
j
a
a
"}
(24,1,1) = {"
a
a
a
a
a
a
j
a
a
a
a
a
a
a
a
j
a
a
"}
(25,1,1) = {"
a
a
a
a
a
a
a
a
a
a
a
a
a
a
a
a
a
a
"}
(26,1,1) = {"
a
a
a
a
a
a
a
a
a
a
a
a
a
a
a
a
a
a
"}
(27,1,1) = {"
a
a
a
a
a
a
a
a
a
a
a
a
a
a
a
a
a
a
"}
(28,1,1) = {"
a
a
a
a
a
a
a
a
a
a
a
a
a
a
a
a
a
a
"}
(29,1,1) = {"
a
a
a
a
a
a
a
a
a
a
a
a
a
a
a
a
a
a
"}
(30,1,1) = {"
a
a
a
a
a
a
a
a
a
a
a
a
a
a
a
a
a
a
"}
