//MAP CONVERTED BY dmm2tgm.py THIS HEADER COMMENT PREVENTS RECONVERSION, DO NOT REMOVE
"a" = (
/turf/open/space/basic,
/area/space)
"b" = (
/turf/closed/wall/mineral/gold,
/area/ruin/space/has_grav/powered)
"c" = (
/obj/effect/turf_decal/arrows/red{
	dir = 1
	},
/turf/open/floor/carpet/purple,
/area/ruin/space/has_grav/powered)
"d" = (
/turf/open/floor/carpet/purple,
/area/ruin/space/has_grav/powered)
"e" = (
/turf/open/floor/light/colour_cycle/dancefloor_a,
/area/ruin/space/has_grav/powered)
"f" = (
/obj/effect/turf_decal/arrows/red{
	dir = 1
	},
/obj/effect/mob_spawn/human/clown/corpse,
/turf/open/floor/carpet/black,
/area/ruin/space/has_grav/powered)
"g" = (
/obj/structure/cursed_slot_machine,
/obj/effect/turf_decal/bot_red,
/obj/machinery/light/small{
	dir = 1
	},
/turf/open/indestructible/gold,
/area/ruin/space/has_grav/powered)
"h" = (
/obj/structure/window/reinforced,
/obj/machinery/computer/arcade{
	dir = 4;
	icon_state = "arcade"
	},
/turf/open/floor/carpet/black,
/area/ruin/space/has_grav/powered)
"i" = (
/obj/machinery/computer/arcade{
	dir = 4;
	icon_state = "arcade"
	},
/turf/open/floor/carpet/black,
/area/ruin/space/has_grav/powered)
"j" = (
/obj/structure/window/reinforced/fulltile,
/turf/open/floor/carpet/purple,
/area/ruin/space/has_grav/powered)
"k" = (
/obj/machinery/computer/arcade{
	dir = 8;
	icon_state = "arcade"
	},
/turf/open/floor/carpet/purple,
/area/ruin/space/has_grav/powered)
"l" = (
/obj/machinery/computer/slot_machine,
/obj/machinery/light/small,
/turf/open/floor/carpet/purple,
/area/ruin/space/has_grav/powered)
"m" = (
/obj/structure/table/wood/poker,
/obj/item/gobbler,
/turf/open/floor/carpet/purple,
/area/ruin/space/has_grav/powered)
"n" = (
/obj/machinery/door/airlock/gold,
/obj/structure/fans/tiny,
/turf/open/floor/carpet/purple,
/area/ruin/space/has_grav/powered)
"o" = (
/obj/structure/table/wood/fancy/purple,
/obj/item/storage/belt/military/snack,
/turf/open/floor/carpet/purple,
/area/ruin/space/has_grav/powered)
"p" = (
/obj/structure/closet/crate/wooden{
	name = "prize crate"
	},
/obj/item/choice_beacon/pet,
/obj/item/coin/arcade_token,
/obj/item/coin/arcade_token,
/obj/item/coin/arcade_token,
/obj/item/coin/arcade_token,
/obj/item/coin/arcade_token,
/obj/item/coin/arcade_token,
/obj/item/coin/arcade_token,
/obj/item/coin/arcade_token,
/obj/item/coin/arcade_token,
/obj/item/coin/arcade_token,
/obj/machinery/light/small{
	dir = 1
	},
/turf/open/floor/carpet/purple,
/area/ruin/space/has_grav/powered)
"q" = (
/obj/machinery/light/small{
	dir = 1
	},
/turf/open/floor/carpet/purple,
/area/ruin/space/has_grav/powered)
"r" = (
/obj/machinery/computer/arcade{
	dir = 8;
	icon_state = "arcade"
	},
/turf/open/floor/carpet/black,
/area/ruin/space/has_grav/powered)
"s" = (
/turf/closed/mineral,
/area/ruin/space/has_grav/powered)
"t" = (
/obj/machinery/computer/arcade{
	dir = 4;
	icon_state = "arcade"
	},
/turf/open/floor/carpet/purple,
/area/ruin/space/has_grav/powered)
"u" = (
/obj/structure/statue/gold/cmo,
/turf/open/indestructible/gold,
/area/ruin/space/has_grav/powered)
"A" = (
/turf/open/floor/carpet/black,
/area/ruin/space/has_grav/powered)
"B" = (
/obj/effect/turf_decal/arrows/red{
	dir = 1
	},
/turf/open/floor/light/colour_cycle/dancefloor_a,
/area/ruin/space/has_grav/powered)
"D" = (
/obj/structure/window/reinforced,
/turf/open/floor/carpet/black,
/area/ruin/space/has_grav/powered)
"H" = (
/obj/machinery/door/window/westleft,
/turf/open/floor/carpet/purple,
/area/ruin/space/has_grav/powered)
"I" = (
/obj/machinery/computer/slot_machine,
/turf/open/floor/carpet/black,
/area/ruin/space/has_grav/powered)
"J" = (
/obj/structure/window/reinforced,
/obj/machinery/computer/arcade{
	dir = 8;
	icon_state = "arcade"
	},
/turf/open/floor/carpet/black,
/area/ruin/space/has_grav/powered)
"L" = (
/obj/machinery/jukebox/disco/indestructible,
/turf/open/floor/light/colour_cycle/dancefloor_a,
/area/ruin/space/has_grav/powered)
"V" = (
/obj/structure/window/reinforced/fulltile,
/turf/open/floor/carpet/black,
/area/ruin/space/has_grav/powered)
"W" = (
/obj/structure/closet/crate/freezer{
	name = "refreshment cooler"
	},
/obj/item/reagent_containers/food/drinks/beer/light,
/obj/item/reagent_containers/food/drinks/soda_cans/sodawater,
/obj/item/reagent_containers/food/drinks/soda_cans/shamblers,
/obj/item/reagent_containers/food/drinks/soda_cans/shamblers,
/obj/item/reagent_containers/food/drinks/soda_cans/grey_bull,
/obj/item/reagent_containers/food/drinks/soda_cans/grey_bull,
/obj/item/reagent_containers/food/drinks/soda_cans/air,
/obj/item/reagent_containers/food/drinks/soda_cans/dr_gibb,
/obj/item/reagent_containers/food/drinks/soda_cans/dr_gibb,
/obj/item/reagent_containers/food/drinks/soda_cans/cola,
/obj/item/reagent_containers/food/drinks/soda_cans/cola,
/obj/item/reagent_containers/food/drinks/soda_cans/pwr_game,
/obj/item/reagent_containers/food/drinks/soda_cans/pwr_game,
/obj/item/reagent_containers/food/drinks/soda_cans/space_up,
/obj/item/reagent_containers/food/drinks/soda_cans/space_up,
/obj/item/reagent_containers/food/drinks/soda_cans/starkist,
/obj/machinery/light/small,
/turf/open/floor/carpet/purple,
/area/ruin/space/has_grav/powered)
"Y" = (
/obj/machinery/door/window/eastright,
/turf/open/floor/carpet/purple,
/area/ruin/space/has_grav/powered)
"Z" = (
/obj/structure/statue/gold/hop,
/obj/machinery/light/small{
	dir = 1
	},
/turf/open/indestructible/gold,
/area/ruin/space/has_grav/powered)

(1,1,1) = {"
a
a
a
a
a
a
a
a
a
a
a
a
a
a
a
a
a
a
a
a
"}
(2,1,1) = {"
a
a
a
a
a
a
a
a
a
a
a
a
a
a
a
a
a
a
a
a
"}
(3,1,1) = {"
a
a
a
a
a
a
a
a
a
a
a
a
a
a
a
a
a
a
a
a
"}
(4,1,1) = {"
a
a
a
a
a
a
a
a
a
a
a
a
a
a
s
s
a
a
a
a
"}
(5,1,1) = {"
a
a
a
a
s
s
s
s
a
b
j
j
j
b
b
s
s
a
a
a
"}
(6,1,1) = {"
a
a
a
s
s
s
s
s
s
b
p
d
d
W
b
s
s
s
a
a
"}
(7,1,1) = {"
a
a
s
s
s
s
s
s
b
b
m
m
Y
b
b
s
s
a
a
a
"}
(8,1,1) = {"
a
a
s
s
s
b
b
b
b
Z
d
d
d
t
b
b
s
a
a
a
"}
(9,1,1) = {"
a
s
s
s
b
b
i
i
h
d
d
d
d
d
l
b
b
b
a
a
"}
(10,1,1) = {"
a
s
s
s
b
I
A
A
D
d
d
e
e
e
d
d
u
V
a
a
"}
(11,1,1) = {"
a
s
s
s
b
I
A
A
d
d
e
e
e
e
e
d
d
V
a
a
"}
(12,1,1) = {"
a
a
s
s
b
g
f
d
d
c
e
B
L
e
B
d
c
n
a
a
"}
(13,1,1) = {"
a
a
s
s
b
I
A
A
d
d
e
e
e
e
e
d
d
V
a
a
"}
(14,1,1) = {"
a
s
s
s
b
I
A
A
D
d
d
e
e
e
d
d
u
V
a
a
"}
(15,1,1) = {"
a
s
s
s
b
b
r
r
J
d
d
d
d
d
l
b
b
b
a
a
"}
(16,1,1) = {"
a
s
s
s
s
b
b
b
b
Z
d
d
d
k
b
b
s
a
a
a
"}
(17,1,1) = {"
a
a
s
s
s
s
s
s
b
b
o
o
H
b
b
s
s
s
a
a
"}
(18,1,1) = {"
a
a
a
s
s
s
s
s
a
b
q
d
d
W
b
s
s
a
a
a
"}
(19,1,1) = {"
a
a
a
a
a
s
s
a
a
b
j
j
j
b
b
s
a
a
a
a
"}
(20,1,1) = {"
a
a
a
a
a
a
a
a
a
a
a
a
a
a
a
a
a
a
a
a
"}
(21,1,1) = {"
a
a
a
a
a
a
a
a
a
a
a
a
a
a
a
a
a
a
a
a
"}
(22,1,1) = {"
a
a
a
a
a
a
a
a
a
a
a
a
a
a
a
a
a
a
a
a
"}
(23,1,1) = {"
a
a
a
a
a
a
a
a
a
a
a
a
a
a
a
a
a
a
a
a
"}
(24,1,1) = {"
a
a
a
a
a
a
a
a
a
a
a
a
a
a
a
a
a
a
a
a
"}
(25,1,1) = {"
a
a
a
a
a
a
a
a
a
a
a
a
a
a
a
a
a
a
a
a
"}
