//MAP CONVERTED BY dmm2tgm.py THIS HEADER COMMENT PREVENTS RECONVERSION, DO NOT REMOVE
"aa" = (
/turf/template_noop,
/area/template_noop)
"ab" = (
/obj/structure/lattice,
/turf/template_noop,
/area/space/nearstation)
"ac" = (
/obj/structure/grille,
/turf/open/floor/plating/airless,
/area/ruin/space/has_grav/turretedoutpost)
"ad" = (
/turf/closed/wall/r_wall,
/area/ruin/space/has_grav/turretedoutpost)
"ae" = (
/obj/structure/table/reinforced,
/obj/item/stock_parts/cell/hyper,
/turf/open/floor/plasteel,
/area/ruin/space/has_grav/turretedoutpost)
"af" = (
/obj/structure/table/reinforced,
/obj/item/radio{
	pixel_x = 6;
	pixel_y = 8
	},
/obj/item/folder/documents{
	pixel_x = -7;
	pixel_y = 0
	},
/obj/effect/decal/cleanable/dirt/dust,
/turf/open/floor/plasteel,
/area/ruin/space/has_grav/turretedoutpost)
"ag" = (
/turf/open/floor/plasteel,
/area/ruin/space/has_grav/turretedoutpost)
"ah" = (
/mob/living/simple_animal/hostile/russian,
/turf/open/floor/plasteel/dark,
/area/ruin/space/has_grav/turretedoutpost)
"ai" = (
/obj/machinery/door/airlock/external,
/obj/effect/mapping_helpers/airlock/cyclelink_helper{
	dir = 4
	},
/turf/open/floor/plating,
/area/ruin/space/has_grav/turretedoutpost)
"aj" = (
/obj/machinery/light{
	dir = 1
	},
/turf/open/floor/plating,
/area/ruin/space/has_grav/turretedoutpost)
"ak" = (
/turf/open/floor/plating,
/area/ruin/space/has_grav/turretedoutpost)
"al" = (
/turf/open/floor/plating/airless,
/area/ruin/space/has_grav/turretedoutpost)
"am" = (
/obj/structure/table/reinforced,
/obj/item/reagent_containers/food/drinks/bottle/vodka{
	pixel_x = -8;
	pixel_y = 14
	},
/obj/item/reagent_containers/food/snacks/beans{
	pixel_x = 6;
	pixel_y = 8
	},
/turf/open/floor/plasteel,
/area/ruin/space/has_grav/turretedoutpost)
"an" = (
/mob/living/simple_animal/hostile/russian/ranged/officer,
/turf/open/floor/plasteel,
/area/ruin/space/has_grav/turretedoutpost)
"ao" = (
/obj/machinery/porta_turret,
/turf/open/floor/plating/airless,
/area/ruin/space/has_grav/turretedoutpost)
"ap" = (
/obj/structure/filingcabinet,
/turf/open/floor/plasteel,
/area/ruin/space/has_grav/turretedoutpost)
"aq" = (
/obj/machinery/light,
/obj/effect/decal/cleanable/dirt/dust,
/turf/open/floor/plasteel,
/area/ruin/space/has_grav/turretedoutpost)
"ar" = (
/obj/machinery/power/apc{
	name = "Worn-out APC";
	pixel_y = -24
	},
/obj/effect/decal/cleanable/dirt/dust,
/turf/open/floor/plasteel,
/area/ruin/space/has_grav/turretedoutpost)
"as" = (
/obj/structure/rack,
/obj/effect/turf_decal/tile/neutral{
	dir = 1
	},
/obj/effect/turf_decal/tile/neutral{
	dir = 4
	},
/obj/item/camera_bug,
/turf/open/floor/plasteel/dark,
/area/ruin/space/has_grav/turretedoutpost)
"at" = (
/obj/effect/turf_decal/tile/neutral{
	dir = 1
	},
/obj/effect/turf_decal/tile/neutral{
	dir = 4
	},
/obj/effect/spawner/lootdrop/salvage,
/turf/open/floor/plasteel/dark,
/area/ruin/space/has_grav/turretedoutpost)
"au" = (
/obj/machinery/light{
	dir = 1
	},
/obj/effect/turf_decal/tile/neutral{
	dir = 1
	},
/obj/effect/turf_decal/tile/neutral{
	dir = 4
	},
/obj/effect/spawner/lootdrop/salvage,
/turf/open/floor/plasteel/dark,
/area/ruin/space/has_grav/turretedoutpost)
"av" = (
/obj/structure/rack,
/obj/item/firing_pin,
/obj/effect/turf_decal/tile/neutral{
	dir = 1
	},
/obj/effect/turf_decal/tile/neutral{
	dir = 4
	},
/turf/open/floor/plasteel/dark,
/area/ruin/space/has_grav/turretedoutpost)
"aw" = (
/obj/machinery/door/airlock/public/glass,
/turf/open/floor/plasteel,
/area/ruin/space/has_grav/turretedoutpost)
"ax" = (
/obj/machinery/door/airlock,
/turf/open/floor/plasteel,
/area/ruin/space/has_grav/turretedoutpost)
"ay" = (
/obj/effect/turf_decal/tile/neutral{
	dir = 1
	},
/obj/effect/turf_decal/tile/neutral{
	dir = 8
	},
/obj/effect/spawner/lootdrop/salvage,
/turf/open/floor/plasteel/dark,
/area/ruin/space/has_grav/turretedoutpost)
"az" = (
/turf/open/floor/plasteel/dark,
/area/ruin/space/has_grav/turretedoutpost)
"aA" = (
/obj/structure/tank_dispenser/oxygen,
/turf/open/floor/plasteel/dark,
/area/ruin/space/has_grav/turretedoutpost)
"aB" = (
/obj/structure/table/reinforced,
/obj/effect/turf_decal/tile/red{
	dir = 4
	},
/obj/effect/turf_decal/tile/red{
	dir = 1
	},
/obj/effect/turf_decal/tile/red{
	dir = 8
	},
/obj/item/reagent_containers/glass/beaker/waterbottle/wataur,
/turf/open/floor/plasteel,
/area/ruin/space/has_grav/turretedoutpost)
"aC" = (
/obj/structure/reagent_dispensers/peppertank{
	pixel_y = 32
	},
/obj/machinery/computer{
	desc = "A computer long since rendered non-functional due to lack of maintenance. Spitting out error messages.";
	dir = 2;
	name = "Broken Computer"
	},
/turf/open/floor/plasteel,
/area/ruin/space/has_grav/turretedoutpost)
"aD" = (
/obj/structure/table/reinforced,
/obj/item/clipboard,
/obj/machinery/light{
	dir = 1
	},
/obj/item/radio{
	pixel_x = 8;
	pixel_y = 8
	},
/turf/open/floor/plasteel,
/area/ruin/space/has_grav/turretedoutpost)
"aE" = (
/obj/structure/rack,
/obj/effect/turf_decal/tile/neutral{
	dir = 1
	},
/obj/effect/turf_decal/tile/neutral,
/obj/effect/turf_decal/tile/neutral{
	dir = 4
	},
/obj/effect/turf_decal/tile/neutral{
	dir = 8
	},
/obj/item/clothing/head/welding/tagilla,
/turf/open/floor/plasteel/dark,
/area/ruin/space/has_grav/turretedoutpost)
"aF" = (
/obj/structure/rack,
/obj/effect/turf_decal/tile/neutral{
	dir = 1
	},
/obj/effect/turf_decal/tile/neutral{
	dir = 8
	},
/obj/item/clothing/head/helmet/rus_cap,
/turf/open/floor/plasteel/dark,
/area/ruin/space/has_grav/turretedoutpost)
"aG" = (
/obj/structure/rack,
/obj/effect/turf_decal/tile/neutral{
	dir = 1
	},
/obj/effect/turf_decal/tile/neutral,
/obj/effect/turf_decal/tile/neutral{
	dir = 4
	},
/obj/effect/turf_decal/tile/neutral{
	dir = 8
	},
/obj/item/firing_pin/clown,
/turf/open/floor/plasteel/dark,
/area/ruin/space/has_grav/turretedoutpost)
"aH" = (
/obj/structure/rack,
/obj/effect/turf_decal/tile/neutral{
	dir = 1
	},
/obj/effect/turf_decal/tile/neutral,
/obj/effect/turf_decal/tile/neutral{
	dir = 4
	},
/obj/effect/turf_decal/tile/neutral{
	dir = 8
	},
/obj/item/ammo_box/c9mm,
/turf/open/floor/plasteel/dark,
/area/ruin/space/has_grav/turretedoutpost)
"aI" = (
/obj/machinery/door/airlock/security,
/turf/open/floor/plasteel/dark,
/area/ruin/space/has_grav/turretedoutpost)
"aK" = (
/obj/structure/dresser,
/obj/item/reagent_containers/food/drinks/bottle/vodka{
	pixel_x = 6;
	pixel_y = 21
	},
/obj/item/reagent_containers/food/drinks/britcup{
	pixel_x = -6;
	pixel_y = 11
	},
/turf/open/floor/plasteel,
/area/ruin/space/has_grav/turretedoutpost)
"aL" = (
/obj/structure/rack,
/obj/effect/turf_decal/tile/neutral{
	dir = 1
	},
/obj/effect/turf_decal/tile/neutral{
	dir = 8
	},
/obj/item/clothing/head/ushanka,
/turf/open/floor/plasteel/dark,
/area/ruin/space/has_grav/turretedoutpost)
"aM" = (
/obj/structure/rack,
/obj/item/crowbar/red,
/obj/item/paper/crumpled,
/obj/effect/turf_decal/tile/neutral{
	dir = 1
	},
/obj/effect/turf_decal/tile/neutral,
/obj/effect/turf_decal/tile/neutral{
	dir = 4
	},
/obj/effect/turf_decal/tile/neutral{
	dir = 8
	},
/turf/open/floor/plasteel/dark,
/area/ruin/space/has_grav/turretedoutpost)
"aN" = (
/obj/structure/bed,
/turf/open/floor/plasteel,
/area/ruin/space/has_grav/turretedoutpost)
"aO" = (
/obj/machinery/light{
	dir = 8
	},
/obj/machinery/vending/sovietsoda/waterfuck,
/turf/open/floor/plasteel,
/area/ruin/space/has_grav/turretedoutpost)
"aP" = (
/obj/structure/bed,
/obj/machinery/light{
	dir = 4
	},
/turf/open/floor/plasteel,
/area/ruin/space/has_grav/turretedoutpost)
"aQ" = (
/obj/structure/rack,
/obj/item/grenade/chem_grenade/teargas,
/turf/open/floor/plasteel/dark,
/area/ruin/space/has_grav/turretedoutpost)
"aR" = (
/obj/machinery/vending/cigarette,
/obj/effect/turf_decal/tile/red{
	dir = 1
	},
/obj/effect/turf_decal/tile/red{
	dir = 8
	},
/obj/effect/turf_decal/tile/red,
/turf/open/floor/plasteel,
/area/ruin/space/has_grav/turretedoutpost)
"aS" = (
/obj/structure/table/reinforced,
/obj/item/paper/crumpled,
/turf/open/floor/plasteel,
/area/ruin/space/has_grav/turretedoutpost)
"aT" = (
/obj/structure/table/reinforced,
/obj/item/paper_bin,
/obj/item/pen/blue,
/turf/open/floor/plasteel,
/area/ruin/space/has_grav/turretedoutpost)
"aU" = (
/obj/structure/table/reinforced,
/obj/item/healthanalyzer/advanced{
	pixel_x = -4;
	pixel_y = 11
	},
/obj/item/storage/firstaid/ancient{
	pixel_x = 5;
	pixel_y = 1
	},
/turf/open/floor/plasteel,
/area/ruin/space/has_grav/turretedoutpost)
"aV" = (
/obj/structure/table/wood,
/obj/item/reagent_containers/food/snacks/beans{
	pixel_x = 6;
	pixel_y = 8
	},
/turf/open/floor/plasteel,
/area/ruin/space/has_grav/turretedoutpost)
"aW" = (
/obj/structure/rack,
/obj/effect/turf_decal/tile/neutral,
/obj/effect/turf_decal/tile/neutral{
	dir = 8
	},
/obj/item/gun/ballistic/automatic/pistol/m9mmpistol,
/turf/open/floor/plasteel/dark,
/area/ruin/space/has_grav/turretedoutpost)
"aX" = (
/obj/effect/turf_decal/tile/neutral,
/obj/effect/turf_decal/tile/neutral{
	dir = 8
	},
/obj/effect/spawner/lootdrop/salvage,
/turf/open/floor/plasteel/dark,
/area/ruin/space/has_grav/turretedoutpost)
"aY" = (
/obj/structure/rack,
/obj/item/storage/belt/military,
/obj/machinery/light,
/obj/effect/turf_decal/tile/neutral,
/obj/effect/turf_decal/tile/neutral{
	dir = 8
	},
/turf/open/floor/plasteel/dark,
/area/ruin/space/has_grav/turretedoutpost)
"aZ" = (
/obj/structure/rack,
/obj/effect/turf_decal/tile/neutral,
/obj/effect/turf_decal/tile/neutral{
	dir = 8
	},
/obj/item/clothing/head/helmet/russian_green_helmet,
/turf/open/floor/plasteel/dark,
/area/ruin/space/has_grav/turretedoutpost)
"ba" = (
/obj/structure/table/wood,
/obj/item/reagent_containers/food/snacks/beans{
	pixel_x = 6;
	pixel_y = 8
	},
/obj/item/reagent_containers/food/drinks/bottle/vodka{
	pixel_x = -8;
	pixel_y = 14
	},
/turf/open/floor/plasteel,
/area/ruin/space/has_grav/turretedoutpost)
"ct" = (
/obj/structure/sign/poster/contraband/hiding{
	pixel_x = 0;
	pixel_y = -31
	},
/obj/structure/table/wood,
/obj/item/reagent_containers/food/snacks/breadslice/meat,
/obj/item/reagent_containers/food/drinks/bottle/vodka{
	pixel_x = 4;
	pixel_y = 19
	},
/turf/open/floor/plasteel,
/area/ruin/space/has_grav/turretedoutpost)
"dZ" = (
/obj/structure/sign/poster/contraband/dancing_honk{
	pixel_x = -32;
	pixel_y = 0
	},
/obj/machinery/washing_machine,
/turf/open/floor/plasteel,
/area/ruin/space/has_grav/turretedoutpost)
"if" = (
/obj/structure/noticeboard{
	pixel_y = 32
	},
/obj/structure/reagent_dispensers/water_cooler,
/turf/open/floor/plasteel,
/area/ruin/space/has_grav/turretedoutpost)
"jL" = (
/obj/structure/dresser,
/obj/item/flashlight/lamp/green{
	pixel_x = -2;
	pixel_y = 15
	},
/turf/open/floor/plasteel,
/area/ruin/space/has_grav/turretedoutpost)
"lx" = (
/obj/structure/rack,
/obj/effect/turf_decal/tile/neutral{
	dir = 1
	},
/obj/effect/turf_decal/tile/neutral{
	dir = 8
	},
/obj/item/gun/ballistic/automatic/pistol/m9mmpistol,
/turf/open/floor/plasteel/dark,
/area/ruin/space/has_grav/turretedoutpost)
"tK" = (
/obj/effect/turf_decal/tile/red{
	dir = 1
	},
/obj/effect/turf_decal/tile/red{
	dir = 8
	},
/turf/open/floor/plasteel,
/area/ruin/space/has_grav/turretedoutpost)
"AG" = (
/obj/effect/decal/cleanable/dirt/dust,
/turf/open/floor/plasteel,
/area/ruin/space/has_grav/turretedoutpost)
"GK" = (
/obj/effect/spawner/lootdrop/salvage,
/obj/structure/sign/poster/contraband/cai{
	pixel_x = 0;
	pixel_y = 32
	},
/turf/open/floor/plasteel,
/area/ruin/space/has_grav/turretedoutpost)
"Id" = (
/obj/structure/chair/office/dark{
	dir = 1
	},
/turf/open/floor/plasteel,
/area/ruin/space/has_grav/turretedoutpost)
"Ml" = (
/obj/effect/spawner/lootdrop/salvage,
/turf/open/floor/plating/airless,
/area/ruin/space/has_grav/turretedoutpost)
"Nu" = (
/obj/machinery/door/airlock/external,
/obj/effect/mapping_helpers/airlock/cyclelink_helper{
	dir = 8
	},
/obj/structure/fans/tiny,
/turf/open/floor/plating,
/area/ruin/space/has_grav/turretedoutpost)
"Wa" = (
/obj/structure/salvage/computer,
/obj/machinery/light{
	dir = 1
	},
/turf/open/floor/plasteel,
/area/ruin/space/has_grav/turretedoutpost)

(1,1,1) = {"
aa
aa
aa
aa
aa
aa
aa
aa
aa
aa
ab
aa
aa
aa
aa
aa
aa
aa
"}
(2,1,1) = {"
aa
aa
aa
aa
aa
aa
aa
aa
aa
aa
ab
ab
ab
aa
ab
aa
aa
aa
"}
(3,1,1) = {"
aa
aa
aa
aa
aa
aa
al
al
al
Ml
ac
ac
al
al
ab
ab
aa
aa
"}
(4,1,1) = {"
aa
aa
aa
aa
aa
al
ao
ad
ad
ad
ad
ad
ad
ao
al
ab
ab
aa
"}
(5,1,1) = {"
aa
aa
aa
aa
aa
al
ad
ad
ay
aF
aL
lx
ad
ad
al
ab
aa
aa
"}
(6,1,1) = {"
aa
ab
ab
ab
ab
ac
ad
as
az
az
az
az
aW
ad
al
ab
aa
aa
"}
(7,1,1) = {"
aa
aa
aa
ab
aa
ac
ad
at
ah
aG
aE
az
aX
ad
Ml
ab
ab
aa
"}
(8,1,1) = {"
aa
aa
ab
ab
aa
ac
ad
au
az
aH
aM
az
aY
ad
ac
aa
aa
aa
"}
(9,1,1) = {"
aa
ab
ab
ab
aa
Ml
ad
av
az
az
az
az
aZ
ad
ac
ab
aa
aa
"}
(10,1,1) = {"
aa
ab
aa
ab
aa
ac
ad
ad
aA
az
az
aQ
ad
ad
al
ab
aa
aa
"}
(11,1,1) = {"
aa
aa
ac
ac
ac
ac
ac
ad
ad
aI
aI
ad
ad
ao
al
ab
aa
aa
"}
(12,1,1) = {"
aa
aa
ac
ad
ad
ad
ad
ad
aB
tK
tK
aR
ad
al
ab
ab
ab
aa
"}
(13,1,1) = {"
aa
aa
ac
ad
ae
am
ap
ad
aC
Id
an
aS
ad
Ml
ab
aa
aa
aa
"}
(14,1,1) = {"
aa
aa
ac
ad
af
ag
aq
ad
aD
ag
ag
aT
ad
ac
aa
aa
aa
aa
"}
(15,1,1) = {"
aa
aa
ac
ad
Wa
Id
ag
aw
ag
ag
ag
aU
ad
ac
ac
ab
ab
ab
"}
(16,1,1) = {"
aa
ab
ac
ad
if
ag
ag
ad
ad
ad
ad
ad
ad
ad
ac
ab
aa
aa
"}
(17,1,1) = {"
aa
aa
ac
ad
GK
AG
ag
ax
ag
dZ
aO
aV
ba
ad
ac
ab
ab
aa
"}
(18,1,1) = {"
aa
ab
ac
ad
ag
ag
ar
ad
ag
ag
ag
ag
ct
ad
ac
aa
aa
aa
"}
(19,1,1) = {"
ab
aa
ac
ad
ai
ai
ad
ad
ag
ag
ag
ag
ag
ad
ac
aa
aa
aa
"}
(20,1,1) = {"
ab
ab
ac
ad
aj
ak
ad
ad
aN
aK
aP
jL
aN
ad
ac
aa
aa
aa
"}
(21,1,1) = {"
aa
ab
ac
ad
ak
ak
ad
ad
ad
ad
ad
ad
ad
ad
ac
ab
ab
aa
"}
(22,1,1) = {"
ab
ab
ac
ad
Nu
Nu
ad
ac
ac
ac
ac
ac
ac
ac
ac
aa
ab
aa
"}
