//MAP CONVERTED BY dmm2tgm.py THIS HEADER COMMENT PREVENTS RECONVERSION, DO NOT REMOVE
"bF" = (
/obj/structure/sink{
	dir = 8;
	pixel_x = -12;
	pixel_y = 2
	},
/obj/structure/mirror{
	pixel_x = -28
	},
/turf/open/floor/plasteel/freezer,
/area/maintenance/central/frozen/upper)
"bL" = (
/obj/structure/rack,
/obj/effect/spawner/lootdrop/maintenance{
	lootcount = 8;
	name = "8maintenance loot spawner"
	},
/obj/effect/spawner/lootdrop/low_tools,
/turf/open/floor/plating/snowed/smoothed/warmer,
/area/maintenance/central/frozen/upper)
"cu" = (
/obj/structure/cable{
	icon_state = "4-8"
	},
/obj/structure/disposalpipe/segment{
	dir = 4
	},
/obj/effect/spawner/lootdrop/maintenance,
/turf/open/floor/plating/snowed/smoothed/warmer,
/area/maintenance/central/frozen/upper)
"cy" = (
/obj/structure/cable{
	icon_state = "4-8"
	},
/obj/structure/disposalpipe/segment{
	dir = 4
	},
/turf/closed/wall/mineral/snow,
/area/maintenance/central/frozen/upper)
"cK" = (
/obj/structure/railing{
	dir = 8
	},
/turf/open/floor/plating/snowed/smoothed/warmer,
/area/maintenance/central/frozen/upper)
"dA" = (
/obj/structure/cable{
	icon_state = "0-4"
	},
/obj/machinery/camera{
	c_tag = "Southern Engineering Post"
	},
/obj/machinery/power/apc{
	areastring = "/area/engineering/substation/service/lower";
	name = "Lower East Engineering Post APC";
	pixel_x = -24
	},
/turf/open/floor/plasteel,
/area/engineering/substation/service/lower)
"dZ" = (
/obj/structure/bed/dogbed,
/turf/open/floor/wood/wood_tiled,
/area/maintenance/central/frozen/upper)
"ee" = (
/obj/structure/toilet/secret/high_loot{
	dir = 8
	},
/turf/open/floor/plasteel/freezer,
/area/maintenance/central/frozen/upper)
"em" = (
/turf/open/floor/plating/snowed/smoothed/warmer,
/area/maintenance/central/frozen/upper)
"eI" = (
/turf/open/floor/plating,
/area/engineering/substation/service/lower)
"eU" = (
/obj/structure/cable{
	icon_state = "4-8"
	},
/turf/open/floor/plating/snowed/smoothed/warmer,
/area/maintenance/central/frozen/upper)
"fn" = (
/obj/machinery/light{
	dir = 8
	},
/obj/structure/disposalpipe/segment{
	dir = 4
	},
/turf/open/floor/plasteel,
/area/engineering/substation/service/lower)
"fs" = (
/obj/effect/spawner/lootdrop/maintenance,
/turf/open/floor/wood/wood_tiled,
/area/maintenance/central/frozen/upper)
"fR" = (
/obj/structure/cable{
	icon_state = "4-8"
	},
/obj/structure/disposalpipe/segment{
	dir = 4
	},
/obj/structure/railing/corner{
	dir = 1
	},
/obj/effect/spawner/lootdrop/glowstick,
/turf/open/floor/plating/snowed/smoothed/warmer,
/area/maintenance/central/frozen/upper)
"ho" = (
/obj/item/radio/intercom{
	pixel_x = -30
	},
/turf/open/floor/plasteel,
/area/engineering/substation/service/lower)
"hy" = (
/obj/structure/railing{
	dir = 6
	},
/turf/open/floor/plating/snowed/smoothed/warmer,
/area/maintenance/central/frozen/upper)
"hQ" = (
/obj/structure/disposalpipe/segment{
	dir = 4
	},
/obj/machinery/atmospherics/pipe/simple/supply/hidden/layer1{
	dir = 4
	},
/obj/machinery/atmospherics/pipe/simple/scrubbers/hidden/layer3{
	dir = 4
	},
/turf/closed/wall/mineral/snow,
/area/maintenance/central/frozen/upper)
"it" = (
/obj/structure/table/wood,
/obj/item/reagent_containers/food/drinks/mug/coco{
	pixel_x = -8;
	pixel_y = 9
	},
/obj/item/reagent_containers/food/drinks/mug/coco{
	pixel_x = 6;
	pixel_y = 11
	},
/turf/open/floor/wood/wood_tiled,
/area/maintenance/central/frozen/upper)
"iw" = (
/obj/structure/disposalpipe/segment{
	dir = 4
	},
/obj/machinery/atmospherics/pipe/simple/supply/hidden/layer1{
	dir = 4
	},
/obj/machinery/atmospherics/pipe/simple/scrubbers/hidden/layer3{
	dir = 4
	},
/obj/effect/spawner/lootdrop/glowstick,
/turf/open/floor/plating/snowed/smoothed/warmer,
/area/maintenance/central/frozen/upper)
"iZ" = (
/obj/machinery/power/deck_relay,
/obj/structure/cable{
	icon_state = "0-2"
	},
/turf/open/floor/plating,
/area/engineering/substation/service/lower)
"jb" = (
/turf/open/openspace,
/area/maintenance/central/frozen/upper)
"jq" = (
/obj/structure/disposalpipe/segment{
	dir = 5
	},
/obj/machinery/atmospherics/pipe/simple/scrubbers/hidden/layer3{
	dir = 5
	},
/obj/machinery/atmospherics/pipe/simple/supply/hidden/layer1{
	dir = 5
	},
/turf/open/floor/plating/snowed/smoothed/warmer,
/area/maintenance/central/frozen/upper)
"jZ" = (
/obj/effect/spawner/structure/window/reinforced,
/turf/open/floor/plating,
/area/engineering/substation/service/lower)
"kI" = (
/obj/structure/window/reinforced{
	dir = 8
	},
/obj/machinery/atmospherics/pipe/manifold/scrubbers/hidden{
	dir = 4
	},
/obj/structure/cable{
	icon_state = "1-2"
	},
/obj/structure/disposalpipe/segment{
	dir = 4
	},
/turf/open/floor/plating,
/area/engineering/substation/service/lower)
"kK" = (
/obj/effect/spawner/structure/window/reinforced,
/turf/open/floor/plating/snowed/smoothed/warmer,
/area/maintenance/central/frozen/upper)
"ls" = (
/obj/structure/signpost/exit,
/turf/open/floor/plating/snowed/smoothed/warmer,
/area/maintenance/central/frozen/upper)
"lu" = (
/obj/machinery/atmospherics/pipe/simple/scrubbers/hidden/layer3{
	dir = 9
	},
/obj/machinery/atmospherics/pipe/simple/supply/hidden/layer1{
	dir = 4
	},
/turf/open/floor/plating/snowed/smoothed/warmer,
/area/maintenance/central/frozen/upper)
"lB" = (
/obj/structure/disposalpipe/segment{
	dir = 9
	},
/obj/machinery/atmospherics/pipe/simple/scrubbers/hidden/layer3{
	dir = 4
	},
/obj/machinery/atmospherics/pipe/simple/supply/hidden/layer1{
	dir = 4
	},
/turf/open/floor/plating/snowed/smoothed/warmer,
/area/maintenance/central/frozen/upper)
"mb" = (
/obj/effect/mapping_helpers/airlock/cyclelink_helper{
	dir = 1
	},
/obj/machinery/door/airlock/external{
	name = "External Access";
	req_access_txt = "13"
	},
/obj/structure/fans/tiny,
/turf/open/floor/plating,
/area/maintenance/central/frozen/upper)
"mt" = (
/obj/structure/railing{
	dir = 1
	},
/obj/effect/spawner/lootdrop/grille_or_trash,
/turf/open/floor/plating/snowed/smoothed/warmer,
/area/maintenance/central/frozen/upper)
"mP" = (
/obj/structure/cable{
	icon_state = "4-8"
	},
/obj/structure/disposalpipe/segment{
	dir = 4
	},
/obj/effect/spawner/lootdrop/glowstick,
/turf/closed/wall/mineral/snow,
/area/maintenance/central/frozen/upper)
"nr" = (
/obj/structure/disposalpipe/segment{
	dir = 4
	},
/obj/machinery/atmospherics/pipe/simple/supply/hidden/layer1{
	dir = 4
	},
/obj/machinery/atmospherics/pipe/simple/scrubbers/hidden/layer3{
	dir = 4
	},
/obj/effect/spawner/lootdrop/tool_box,
/turf/open/floor/plating/snowed/smoothed/warmer,
/area/maintenance/central/frozen/upper)
"nz" = (
/obj/structure/disposalpipe/segment{
	dir = 1
	},
/turf/open/floor/plating/snowed/smoothed/warmer,
/area/maintenance/central/frozen/upper)
"nG" = (
/obj/machinery/atmospherics/pipe/simple/multiz{
	dir = 8;
	piping_layer = 1
	},
/turf/open/floor/plating/snowed/smoothed/warmer,
/area/maintenance/central/frozen/upper)
"nR" = (
/obj/structure/railing{
	dir = 9
	},
/turf/open/floor/plating/snowed/smoothed/warmer,
/area/maintenance/central/frozen/upper)
"nS" = (
/obj/effect/spawner/lootdrop/maintenance,
/turf/open/floor/plating/snowed/smoothed/warmer,
/area/maintenance/central/frozen/upper)
"oe" = (
/turf/closed/mineral/random/snow,
/area/icemoon/surface/outdoors)
"qF" = (
/turf/closed/wall/r_wall,
/area/engineering/substation/service/lower)
"qM" = (
/obj/structure/urinal{
	pixel_y = 32
	},
/turf/open/floor/plasteel/freezer,
/area/maintenance/central/frozen/upper)
"qU" = (
/obj/structure/sign/poster/random{
	pixel_y = 32
	},
/turf/open/floor/plating/snowed/smoothed/warmer,
/area/maintenance/central/frozen/upper)
"rD" = (
/obj/structure/railing{
	dir = 1
	},
/turf/open/floor/plating/snowed/smoothed/warmer,
/area/maintenance/central/frozen/upper)
"rL" = (
/obj/structure/railing{
	dir = 10
	},
/turf/open/floor/plating/snowed/smoothed/warmer,
/area/maintenance/central/frozen/upper)
"sl" = (
/turf/open/floor/wood/wood_tiled,
/area/maintenance/central/frozen/upper)
"sr" = (
/obj/structure/disposalpipe/segment{
	dir = 4
	},
/obj/machinery/atmospherics/pipe/simple/supply/hidden/layer1{
	dir = 4
	},
/obj/machinery/atmospherics/pipe/simple/scrubbers/hidden/layer3{
	dir = 4
	},
/obj/machinery/light/floor,
/turf/open/floor/plating/snowed/smoothed/warmer,
/area/maintenance/central/frozen/upper)
"tg" = (
/obj/structure/sign/poster/random{
	pixel_x = 32
	},
/turf/open/floor/plating/snowed/smoothed/warmer,
/area/maintenance/central/frozen/upper)
"uS" = (
/obj/effect/spawner/structure/window/reinforced,
/obj/structure/disposalpipe/segment{
	dir = 4
	},
/turf/open/floor/plating,
/area/engineering/substation/service/lower)
"wb" = (
/obj/structure/disposalpipe/segment,
/turf/open/floor/plating/snowed/smoothed/warmer,
/area/maintenance/central/frozen/upper)
"ww" = (
/obj/structure/disposalpipe/segment{
	dir = 4
	},
/obj/machinery/atmospherics/pipe/simple/supply/hidden/layer1{
	dir = 4
	},
/obj/machinery/atmospherics/pipe/simple/scrubbers/hidden/layer3{
	dir = 4
	},
/obj/effect/spawner/lootdrop/low_tools,
/turf/open/floor/plating/snowed/smoothed/warmer,
/area/maintenance/central/frozen/upper)
"wx" = (
/obj/machinery/atmospherics/pipe/simple/supply/hidden{
	dir = 10
	},
/obj/structure/cable{
	icon_state = "4-8"
	},
/turf/open/floor/plating,
/area/engineering/substation/service/lower)
"wO" = (
/obj/effect/spawner/lootdrop/druggie_pill,
/turf/open/floor/wood/wood_tiled,
/area/maintenance/central/frozen/upper)
"xz" = (
/obj/structure/railing{
	dir = 1
	},
/turf/open/openspace,
/area/maintenance/central/frozen/upper)
"xW" = (
/turf/open/floor/plasteel/freezer,
/area/maintenance/central/frozen/upper)
"ye" = (
/obj/structure/cable{
	icon_state = "4-8"
	},
/obj/machinery/light/floor,
/obj/structure/disposalpipe/segment{
	dir = 4
	},
/turf/open/floor/plating/snowed/smoothed/warmer,
/area/maintenance/central/frozen/upper)
"yh" = (
/obj/structure/disposalpipe/segment{
	dir = 6
	},
/turf/open/floor/plating/snowed/smoothed/warmer,
/area/maintenance/central/frozen/upper)
"yi" = (
/obj/structure/disposalpipe/segment{
	dir = 4
	},
/turf/open/floor/plating/snowed/smoothed/warmer,
/area/maintenance/central/frozen/upper)
"yl" = (
/obj/effect/spawner/lootdrop/druggie_pill,
/turf/open/floor/plating/snowed/smoothed/warmer,
/area/maintenance/central/frozen/upper)
"ym" = (
/obj/structure/disposalpipe/segment{
	dir = 4
	},
/obj/machinery/atmospherics/pipe/simple/supply/hidden/layer1{
	dir = 4
	},
/obj/machinery/atmospherics/pipe/simple/scrubbers/hidden/layer3{
	dir = 4
	},
/obj/effect/spawner/lootdrop/grille_or_trash,
/turf/open/floor/plating/snowed/smoothed/warmer,
/area/maintenance/central/frozen/upper)
"yy" = (
/obj/structure/disposalpipe/segment,
/obj/structure/cable{
	icon_state = "4-8"
	},
/obj/machinery/light/floor,
/turf/open/floor/plating/snowed/smoothed/warmer,
/area/maintenance/central/frozen/upper)
"yz" = (
/obj/machinery/atmospherics/pipe/simple/supply/hidden/layer1,
/turf/open/floor/plating/snowed/smoothed/warmer,
/area/maintenance/central/frozen/upper)
"yH" = (
/obj/structure/cable{
	icon_state = "1-8"
	},
/turf/open/floor/plating,
/area/engineering/substation/service/lower)
"za" = (
/turf/open/floor/plasteel,
/area/engineering/substation/service/lower)
"ze" = (
/obj/machinery/atmospherics/components/unary/vent_scrubber/on{
	dir = 4
	},
/obj/structure/disposalpipe/segment{
	dir = 4
	},
/turf/open/floor/plasteel,
/area/engineering/substation/service/lower)
"Ai" = (
/obj/machinery/atmospherics/pipe/simple/supply/hidden/layer1{
	dir = 9
	},
/obj/effect/spawner/lootdrop/glowstick,
/turf/open/floor/plating/snowed/smoothed/warmer,
/area/maintenance/central/frozen/upper)
"AB" = (
/obj/structure/table/wood,
/obj/item/reagent_containers/food/drinks/mug/tea/green{
	pixel_x = 9;
	pixel_y = 9
	},
/obj/item/reagent_containers/food/drinks/coffee{
	pixel_y = 13;
	pixel_x = -7
	},
/turf/open/floor/wood/wood_tiled,
/area/maintenance/central/frozen/upper)
"Ba" = (
/obj/structure/rack,
/obj/effect/spawner/lootdrop/maintenance/three,
/turf/open/floor/plating/snowed/smoothed/warmer,
/area/maintenance/central/frozen/upper)
"Bi" = (
/obj/structure/disposalpipe/segment{
	dir = 5
	},
/turf/open/floor/plating/snowed/smoothed/warmer,
/area/maintenance/central/frozen/upper)
"Bz" = (
/obj/structure/cable{
	icon_state = "1-8"
	},
/turf/open/floor/plating/snowed/smoothed/warmer,
/area/maintenance/central/frozen/upper)
"BL" = (
/obj/structure/cable{
	icon_state = "4-8"
	},
/obj/structure/disposalpipe/segment{
	dir = 4
	},
/turf/open/floor/plating/snowed/smoothed/warmer,
/area/maintenance/central/frozen/upper)
"Ch" = (
/obj/structure/disposalpipe/segment{
	dir = 9
	},
/obj/structure/cable{
	icon_state = "4-8"
	},
/turf/open/floor/plating/snowed/smoothed/warmer,
/area/maintenance/central/frozen/upper)
"Cw" = (
/obj/structure/disposalpipe/segment,
/obj/machinery/atmospherics/pipe/simple/scrubbers/hidden/layer3{
	dir = 1
	},
/obj/machinery/atmospherics/pipe/simple/supply/hidden/layer1,
/obj/structure/railing{
	dir = 1
	},
/turf/open/floor/plating/snowed/smoothed/warmer,
/area/maintenance/central/frozen/upper)
"CJ" = (
/obj/structure/rack,
/obj/effect/spawner/lootdrop/maintenance/seven,
/turf/open/floor/plating/snowed/smoothed/warmer,
/area/maintenance/central/frozen/upper)
"CK" = (
/obj/structure/closet/secure_closet/freezer/fridge,
/obj/item/reagent_containers/food/drinks/soda_cans/buzz_fuzz,
/obj/item/reagent_containers/food/drinks/soda_cans/buzz_fuzz,
/obj/item/reagent_containers/food/drinks/soda_cans/buzz_fuzz,
/obj/item/reagent_containers/food/drinks/soda_cans/cola,
/obj/item/reagent_containers/food/drinks/soda_cans/cola,
/obj/item/reagent_containers/food/drinks/soda_cans/cola,
/obj/item/reagent_containers/food/drinks/soda_cans/grey_bull,
/obj/item/reagent_containers/food/drinks/soda_cans/lemon_lime,
/obj/item/reagent_containers/food/drinks/soda_cans/lemon_lime,
/obj/item/reagent_containers/food/drinks/soda_cans/sodawater,
/obj/item/reagent_containers/food/drinks/soda_cans/space_up,
/obj/item/reagent_containers/food/drinks/soda_cans/space_up,
/obj/item/reagent_containers/food/drinks/soda_cans/space_mountain_wind,
/obj/item/reagent_containers/food/drinks/soda_cans/space_mountain_wind,
/obj/item/reagent_containers/food/drinks/soda_cans/starkist,
/obj/item/reagent_containers/food/drinks/soda_cans/tonic,
/obj/item/reagent_containers/food/drinks/soda_cans/tonic,
/obj/item/reagent_containers/food/drinks/soda_cans/air,
/obj/item/reagent_containers/food/drinks/soda_cans/air,
/turf/open/floor/carpet/black,
/area/maintenance/central/frozen/upper)
"CN" = (
/obj/machinery/atmospherics/pipe/simple/multiz{
	dir = 8;
	piping_layer = 3
	},
/turf/open/floor/plating/snowed/smoothed/warmer,
/area/maintenance/central/frozen/upper)
"De" = (
/obj/machinery/light/floor,
/obj/structure/sign/poster/random{
	pixel_y = -32
	},
/turf/open/floor/plating/snowed/smoothed/warmer,
/area/maintenance/central/frozen/upper)
"Dj" = (
/obj/machinery/atmospherics/pipe/manifold/supply/hidden{
	dir = 8
	},
/turf/open/floor/plating,
/area/engineering/substation/service/lower)
"Dx" = (
/obj/structure/rack,
/obj/effect/spawner/lootdrop/maintenance{
	lootcount = 4;
	name = "4maintenance loot spawner"
	},
/turf/open/floor/plating/snowed/smoothed/warmer,
/area/maintenance/central/frozen/upper)
"DG" = (
/obj/structure/bookcase/random,
/turf/open/floor/carpet/black,
/area/maintenance/central/frozen/upper)
"DP" = (
/obj/machinery/atmospherics/pipe/simple/multiz{
	dir = 8
	},
/turf/open/floor/plating,
/area/engineering/substation/service/lower)
"DV" = (
/obj/machinery/atmospherics/pipe/simple/supply/hidden,
/obj/structure/disposalpipe/segment{
	dir = 4
	},
/turf/open/floor/plating,
/area/engineering/substation/service/lower)
"EL" = (
/obj/effect/spawner/lootdrop/grille_or_trash,
/obj/structure/sign/poster/random{
	pixel_y = -32
	},
/turf/open/floor/plating/snowed/smoothed/warmer,
/area/maintenance/central/frozen/upper)
"EP" = (
/obj/structure/disposalpipe/segment{
	dir = 10
	},
/turf/open/floor/plating/snowed/smoothed/warmer,
/area/maintenance/central/frozen/upper)
"EV" = (
/turf/open/floor/carpet/black,
/area/maintenance/central/frozen/upper)
"Fn" = (
/obj/machinery/door/airlock/atmos/abandoned{
	name = "Atmospherics Maintenance";
	req_access_txt = "12;24"
	},
/obj/structure/cable{
	icon_state = "1-2"
	},
/turf/open/floor/plasteel,
/area/engineering/substation/service/lower)
"Fz" = (
/obj/machinery/atmospherics/components/binary/valve/digital/on{
	name = "Digital Valve"
	},
/obj/structure/disposalpipe/segment{
	dir = 4
	},
/turf/open/floor/plating,
/area/engineering/substation/service/lower)
"FX" = (
/obj/machinery/atmospherics/pipe/simple/scrubbers/hidden/layer3{
	dir = 4
	},
/obj/machinery/atmospherics/pipe/simple/supply/hidden/layer1{
	dir = 4
	},
/turf/open/floor/plating/snowed/smoothed/warmer,
/area/maintenance/central/frozen/upper)
"Ge" = (
/obj/structure/disposalpipe/trunk/multiz{
	dir = 8
	},
/turf/open/floor/plating,
/area/engineering/substation/service/lower)
"Gm" = (
/obj/structure/disposalpipe/segment{
	dir = 4
	},
/obj/machinery/atmospherics/pipe/simple/supply/hidden/layer1{
	dir = 4
	},
/obj/machinery/atmospherics/pipe/simple/scrubbers/hidden/layer3{
	dir = 4
	},
/turf/open/floor/plating/snowed/smoothed/warmer,
/area/maintenance/central/frozen/upper)
"Gv" = (
/obj/machinery/power/deck_relay,
/obj/structure/cable{
	icon_state = "0-2"
	},
/turf/open/floor/plating/snowed/smoothed/warmer,
/area/maintenance/central/frozen/upper)
"GO" = (
/obj/effect/spawner/lootdrop/grille_or_trash,
/turf/open/floor/plating/snowed/smoothed/warmer,
/area/maintenance/central/frozen/upper)
"Hk" = (
/obj/structure/cable{
	icon_state = "4-8"
	},
/obj/structure/disposalpipe/segment{
	dir = 4
	},
/turf/open/floor/plasteel,
/area/engineering/substation/service/lower)
"HH" = (
/obj/effect/spawner/structure/window/reinforced,
/obj/machinery/atmospherics/pipe/layer_manifold,
/turf/open/floor/plating,
/area/engineering/substation/service/lower)
"HM" = (
/obj/structure/rack,
/obj/effect/spawner/lootdrop/maintenance/five,
/obj/effect/spawner/lootdrop/low_tools,
/turf/open/floor/plating/snowed/smoothed/warmer,
/area/maintenance/central/frozen/upper)
"HO" = (
/obj/machinery/door/airlock{
	name = "Unisex Restrooms"
	},
/turf/open/floor/plasteel/freezer,
/area/maintenance/central/frozen/upper)
"HP" = (
/obj/structure/cable{
	icon_state = "2-4"
	},
/obj/structure/disposalpipe/segment{
	dir = 4
	},
/turf/open/floor/plasteel,
/area/engineering/substation/service/lower)
"IP" = (
/obj/effect/mapping_helpers/airlock/cyclelink_helper,
/obj/machinery/door/airlock/external{
	name = "External Access";
	req_access_txt = "13"
	},
/turf/open/floor/plating,
/area/maintenance/central/frozen/upper)
"JX" = (
/obj/effect/spawner/lootdrop/grille_or_trash,
/obj/structure/sink{
	dir = 8;
	pixel_x = -12;
	pixel_y = 2
	},
/obj/structure/mirror{
	pixel_x = -28
	},
/turf/open/floor/plasteel/freezer,
/area/maintenance/central/frozen/upper)
"Kz" = (
/obj/structure/window/reinforced{
	dir = 8
	},
/obj/machinery/atmospherics/pipe/simple/multiz,
/obj/structure/cable{
	icon_state = "1-2"
	},
/turf/open/floor/plating,
/area/engineering/substation/service/lower)
"Lb" = (
/obj/structure/disposalpipe/trunk/multiz/down{
	dir = 1
	},
/obj/machinery/atmospherics/pipe/simple/scrubbers/hidden/layer3{
	dir = 6
	},
/turf/open/floor/plating/snowed/smoothed/warmer,
/area/maintenance/central/frozen/upper)
"LU" = (
/obj/machinery/atmospherics/pipe/simple/scrubbers/hidden/layer3,
/obj/machinery/light/floor,
/turf/open/floor/plating/snowed/smoothed/warmer,
/area/maintenance/central/frozen/upper)
"LW" = (
/obj/machinery/door/airlock{
	desc = "A small bathroom with a sink, toilet and shower.";
	name = "Bathroom"
	},
/turf/open/floor/plasteel/freezer,
/area/maintenance/central/frozen/upper)
"Mx" = (
/obj/structure/rack,
/obj/effect/spawner/lootdrop/maintenance{
	lootcount = 3;
	name = "3maintenance loot spawner"
	},
/obj/effect/spawner/lootdrop/low_tools,
/turf/open/floor/plating/snowed/smoothed/warmer,
/area/maintenance/central/frozen/upper)
"ML" = (
/obj/structure/sign/poster/random{
	pixel_x = 32
	},
/turf/closed/wall/mineral/snow,
/area/maintenance/central/frozen/upper)
"Nd" = (
/obj/machinery/door/airlock,
/turf/open/floor/carpet/black,
/area/maintenance/central/frozen/upper)
"Ng" = (
/obj/machinery/door/window/northleft{
	dir = 8;
	name = "Atmos Monitoring";
	req_access_txt = "12; 24"
	},
/obj/machinery/atmospherics/pipe/simple/supply/hidden{
	dir = 4
	},
/obj/structure/cable{
	icon_state = "4-8"
	},
/obj/structure/cable{
	icon_state = "2-4"
	},
/turf/open/floor/plating,
/area/engineering/substation/service/lower)
"NC" = (
/obj/effect/spawner/lootdrop/trashbin,
/turf/open/floor/plating/snowed/smoothed/warmer,
/area/maintenance/central/frozen/upper)
"NF" = (
/obj/machinery/camera{
	c_tag = "Northwestern Engineering Post";
	dir = 1
	},
/obj/machinery/light,
/obj/structure/disposalpipe/trunk/multiz{
	dir = 8
	},
/turf/open/floor/plating,
/area/engineering/substation/service/lower)
"NN" = (
/obj/structure/cable{
	icon_state = "4-8"
	},
/obj/structure/disposalpipe/segment{
	dir = 5
	},
/obj/structure/railing{
	dir = 1
	},
/turf/open/floor/plating/snowed/smoothed/warmer,
/area/maintenance/central/frozen/upper)
"Ox" = (
/obj/structure/sign/poster/random{
	pixel_x = -32
	},
/turf/open/floor/plating/snowed/smoothed/warmer,
/area/maintenance/central/frozen/upper)
"ON" = (
/obj/structure/chair/sofa/corner/brown,
/obj/item/book/random{
	pixel_x = -6;
	pixel_y = -6
	},
/turf/open/floor/wood/wood_tiled,
/area/maintenance/central/frozen/upper)
"Pe" = (
/turf/closed/mineral/random/snow,
/area/icemoon/underground/unexplored/rivers)
"PM" = (
/obj/structure/rack,
/obj/effect/spawner/lootdrop/maintenance{
	lootcount = 8;
	name = "8maintenance loot spawner"
	},
/turf/open/floor/plating/snowed/smoothed/warmer,
/area/maintenance/central/frozen/upper)
"QU" = (
/obj/structure/chair/sofa/middle/brown,
/turf/open/floor/wood/wood_tiled,
/area/maintenance/central/frozen/upper)
"Rf" = (
/obj/machinery/light/floor,
/obj/structure/cable{
	icon_state = "1-4"
	},
/obj/structure/railing{
	dir = 1
	},
/turf/open/floor/plating/snowed/smoothed/warmer,
/area/maintenance/central/frozen/upper)
"Rs" = (
/obj/structure/cable{
	icon_state = "4-8"
	},
/obj/machinery/atmospherics/components/unary/vent_pump/on{
	dir = 4
	},
/turf/open/floor/plasteel,
/area/engineering/substation/service/lower)
"Ru" = (
/obj/effect/spawner/lootdrop/maintenance{
	lootcount = 8;
	name = "8maintenance loot spawner"
	},
/obj/structure/rack,
/turf/open/floor/plating/snowed/smoothed/warmer,
/area/maintenance/central/frozen/upper)
"RY" = (
/obj/structure/chair/sofa/left/brown{
	dir = 8
	},
/turf/open/floor/wood/wood_tiled,
/area/maintenance/central/frozen/upper)
"Tx" = (
/obj/structure/fireplace{
	dir = 4
	},
/turf/open/floor/carpet/black,
/area/maintenance/central/frozen/upper)
"TR" = (
/obj/structure/cable{
	icon_state = "4-8"
	},
/obj/structure/disposalpipe/segment{
	dir = 4
	},
/obj/machinery/light/floor,
/turf/open/floor/plating/snowed/smoothed/warmer,
/area/maintenance/central/frozen/upper)
"Uh" = (
/obj/machinery/airalarm/directional/north,
/turf/open/floor/plasteel,
/area/engineering/substation/service/lower)
"Uq" = (
/obj/structure/chair/sofa/right/brown,
/turf/open/floor/wood/wood_tiled,
/area/maintenance/central/frozen/upper)
"UI" = (
/obj/structure/window/reinforced{
	dir = 8
	},
/obj/machinery/atmospherics/pipe/simple/scrubbers/hidden,
/obj/structure/cable{
	icon_state = "1-8"
	},
/obj/structure/disposalpipe/segment{
	dir = 4
	},
/turf/open/floor/plating,
/area/engineering/substation/service/lower)
"UU" = (
/obj/structure/window/reinforced{
	dir = 8
	},
/turf/open/floor/plating,
/area/engineering/substation/service/lower)
"Va" = (
/obj/structure/disposalpipe/trunk/multiz/down,
/obj/machinery/atmospherics/pipe/simple/scrubbers/hidden/layer3{
	dir = 1
	},
/obj/machinery/atmospherics/pipe/simple/supply/hidden/layer1{
	dir = 6
	},
/turf/open/floor/plating/snowed/smoothed/warmer,
/area/maintenance/central/frozen/upper)
"VW" = (
/obj/effect/spawner/lootdrop/grille_or_trash,
/obj/structure/sign/poster/random{
	pixel_y = 32
	},
/turf/open/floor/carpet/black,
/area/maintenance/central/frozen/upper)
"WF" = (
/obj/effect/spawner/lootdrop/glowstick,
/turf/open/floor/plating/snowed/smoothed/warmer,
/area/maintenance/central/frozen/upper)
"XD" = (
/turf/open/floor/plating,
/area/maintenance/central/frozen/upper)
"Ys" = (
/turf/closed/wall/mineral/snow,
/area/maintenance/central/frozen/upper)
"YC" = (
/obj/item/rack_parts,
/turf/open/floor/plating/snowed/smoothed/warmer,
/area/maintenance/central/frozen/upper)
"YG" = (
/obj/effect/spawner/lootdrop/tool_box,
/turf/open/floor/plating/snowed/smoothed/warmer,
/area/maintenance/central/frozen/upper)
"Zi" = (
/obj/structure/sign/poster/random{
	pixel_y = -32
	},
/turf/open/floor/plating/snowed/smoothed/warmer,
/area/maintenance/central/frozen/upper)
"Zx" = (
/obj/structure/railing,
/turf/open/floor/plating/snowed/smoothed/warmer,
/area/maintenance/central/frozen/upper)

(1,1,1) = {"
Pe
Pe
Pe
Pe
Pe
Pe
Pe
Pe
oe
oe
oe
oe
oe
oe
oe
oe
oe
oe
Pe
Pe
Pe
Pe
Pe
Pe
Pe
Pe
Pe
Pe
Pe
Pe
"}
(2,1,1) = {"
Pe
Pe
Pe
Pe
Pe
Pe
Pe
Pe
oe
oe
oe
oe
oe
oe
oe
oe
oe
oe
Pe
Pe
Pe
Pe
Pe
Pe
Pe
Pe
Pe
Pe
Pe
Pe
"}
(3,1,1) = {"
Pe
Pe
Pe
Pe
Pe
Pe
Pe
oe
oe
oe
Ys
Ys
Ys
Ys
Ys
Ys
oe
oe
Pe
Pe
Pe
Pe
Pe
Pe
Pe
Pe
Pe
Pe
Pe
Pe
"}
(4,1,1) = {"
Pe
Pe
Pe
Pe
Pe
Pe
Pe
oe
oe
Ys
Ys
em
NC
xz
jb
Ys
oe
oe
Pe
Pe
Pe
Pe
Pe
Pe
Pe
Pe
Pe
Pe
Pe
Pe
"}
(5,1,1) = {"
Pe
Pe
Pe
Pe
Pe
Pe
Pe
oe
oe
Ys
yl
em
em
xz
jb
Ys
oe
oe
Pe
Pe
Pe
Pe
Pe
Pe
Pe
Pe
Pe
Pe
Pe
Pe
"}
(6,1,1) = {"
Pe
Pe
Pe
Pe
Pe
Pe
Pe
oe
oe
Ys
yh
Lb
Va
Cw
jq
Ys
oe
oe
Pe
Pe
Pe
Pe
Pe
Pe
Pe
Pe
Pe
Pe
Pe
Pe
"}
(7,1,1) = {"
Pe
Pe
Pe
Pe
Pe
Pe
Pe
oe
oe
Ys
yi
CN
nG
mt
Gm
Ys
oe
oe
oe
oe
oe
oe
oe
oe
oe
oe
oe
oe
oe
oe
"}
(8,1,1) = {"
Pe
Pe
Pe
Pe
Pe
Pe
Pe
oe
oe
Ys
EP
Bi
Gv
Rf
iw
Ys
oe
oe
oe
oe
oe
oe
oe
oe
oe
oe
oe
oe
oe
oe
"}
(9,1,1) = {"
Pe
Pe
kK
kK
Ys
Ys
Ys
Ys
Ys
Ys
Ys
EP
nz
NN
iw
Ys
Ys
Ys
Ys
Ys
Ys
Ys
Ys
Ys
Ys
Ys
Ys
Ys
oe
oe
"}
(10,1,1) = {"
Pe
Pe
kK
Ba
Ys
HM
Ys
em
em
em
Ys
cK
cK
fR
iw
em
em
em
em
em
tg
em
em
em
em
em
YC
Ys
oe
oe
"}
(11,1,1) = {"
Pe
Pe
Ys
em
Ys
em
Ys
em
Ys
tg
Ox
em
ls
BL
Gm
Ys
Ys
Ys
Ys
Ys
Ys
Ys
Ys
Ys
Ys
Ys
em
Ys
oe
oe
"}
(12,1,1) = {"
Pe
Pe
Ys
Zi
Ys
em
rD
em
Ys
Ys
Ys
Ys
Ys
mP
hQ
Ys
GO
em
em
em
em
em
em
yl
em
em
em
Ys
oe
oe
"}
(13,1,1) = {"
Pe
Pe
Ys
em
Ys
em
Ys
em
em
em
em
em
em
cy
sr
Ys
em
em
em
nS
nS
Ys
em
Ys
Ys
Ys
Ys
Ys
oe
oe
"}
(14,1,1) = {"
Pe
Pe
Ys
em
Ys
em
Ys
Ys
Ys
Ys
Ys
Ys
De
cy
Gm
Ys
qU
em
Ys
Ys
Ys
Ys
em
em
em
em
em
Ys
oe
oe
"}
(15,1,1) = {"
Pe
Pe
Ys
em
Ys
em
Ys
yl
em
em
em
em
em
BL
ww
Ys
em
em
em
em
nS
Ys
Ys
Ys
Ys
Ys
em
Ys
oe
oe
"}
(16,1,1) = {"
Pe
Pe
Ys
em
em
em
Ys
em
Ys
Ys
Ys
Ys
Ys
cy
Gm
Ys
Mx
em
em
em
em
Ys
em
EL
Ys
Dx
em
Ys
oe
oe
"}
(17,1,1) = {"
Pe
Pe
Ys
Ys
Ys
Ys
Ys
cK
Ys
em
em
em
em
cu
Gm
Ys
Ys
Ys
Ys
em
em
Ys
em
em
Ys
em
em
Ys
oe
oe
"}
(18,1,1) = {"
Pe
Pe
Ys
nS
em
em
em
em
Ys
em
Ys
Ys
em
TR
Gm
Ys
em
em
em
em
em
em
em
em
Ys
em
em
Ys
oe
oe
"}
(19,1,1) = {"
Pe
Pe
kK
em
Ys
Ys
Ys
Ys
Ys
em
Ys
Ys
em
BL
Gm
Ys
GO
em
em
em
em
em
em
nS
Ys
em
nS
Ys
oe
oe
"}
(20,1,1) = {"
kK
kK
kK
em
Ys
em
em
em
tg
em
Ys
Ys
Ys
cy
hQ
Ys
Ys
Ys
Ys
Ys
Ys
em
Ys
Ys
Ys
em
em
kK
oe
oe
"}
(21,1,1) = {"
IP
XD
mb
em
Ys
em
Ys
Ys
Ys
Ys
Ys
GO
Ys
BL
Gm
em
em
em
Dx
Ys
em
em
em
em
hy
em
em
kK
kK
kK
"}
(22,1,1) = {"
kK
kK
kK
Zi
Ys
nS
em
em
em
em
em
Zi
Ys
ye
Gm
nR
rL
em
em
Ys
qU
em
em
Ys
em
em
em
IP
XD
mb
"}
(23,1,1) = {"
Pe
Pe
kK
em
Ys
Ys
Ys
Ys
Ys
Ys
Ys
em
Ys
BL
Gm
rD
Zx
em
em
Ys
em
em
em
Ys
Ys
Ys
Ys
kK
kK
kK
"}
(24,1,1) = {"
Pe
Pe
Ys
em
Ys
em
em
em
em
em
em
em
Ys
cu
Gm
rD
Zx
em
em
Ys
em
yl
em
em
em
em
em
kK
oe
oe
"}
(25,1,1) = {"
Pe
Pe
Ys
em
Ys
Ys
Ys
Ys
Ys
HO
Ys
Ys
Ys
BL
Gm
rD
Zx
em
em
Ys
nS
em
em
em
GO
Ys
em
Ys
oe
oe
"}
(26,1,1) = {"
Pe
Pe
Ys
em
em
em
em
GO
Ys
xW
bF
JX
Ys
BL
Gm
Ys
Ys
Ys
Ys
Ys
Ys
Ys
Ys
Ys
Ys
Ys
em
Ys
oe
oe
"}
(27,1,1) = {"
Pe
Pe
Ys
em
em
yl
em
Zi
Ys
qM
xW
xW
Ys
BL
Gm
em
em
em
Ox
em
em
em
em
Ox
Ys
PM
em
Ys
oe
oe
"}
(28,1,1) = {"
Pe
Pe
Ys
em
em
em
em
CJ
Ys
qM
xW
xW
Ys
TR
nr
em
em
em
em
em
GO
Ys
em
em
Ys
em
em
Ys
oe
oe
"}
(29,1,1) = {"
Pe
Pe
Ys
em
em
em
CJ
bL
Ys
LW
Ys
LW
Ys
cy
hQ
Ys
em
Ys
Ys
Ys
Ys
Ys
em
em
Ys
em
em
Ys
oe
oe
"}
(30,1,1) = {"
Pe
Pe
Ys
Ys
Ys
Ys
kK
kK
Ys
ee
ML
ee
Ys
BL
ym
Ys
em
em
em
em
em
Ys
em
em
Ys
em
em
Ys
oe
oe
"}
(31,1,1) = {"
Pe
Pe
Pe
Pe
Pe
Pe
oe
kK
kK
Ys
Ys
Ys
Ys
BL
Gm
Ys
em
em
em
em
Ru
Ys
em
em
em
em
em
Ys
oe
oe
"}
(32,1,1) = {"
Pe
Pe
Pe
Pe
Pe
oe
oe
oe
kK
em
yh
wb
wb
Ch
Gm
Ys
em
em
Ys
Ys
Ys
Ys
Ys
Ys
Ys
Ys
Nd
Ys
oe
oe
"}
(33,1,1) = {"
Pe
Pe
Pe
Pe
Pe
oe
oe
oe
kK
em
yi
yh
wb
yy
lB
Ys
em
em
Ys
CK
EV
EV
EV
Tx
EV
EV
EV
Ys
oe
oe
"}
(34,1,1) = {"
Pe
Pe
Pe
Pe
oe
oe
qF
qF
qF
qF
uS
uS
jZ
eU
FX
Ys
em
nR
Ys
VW
EV
EV
EV
EV
EV
EV
EV
Ys
oe
oe
"}
(35,1,1) = {"
Pe
Pe
Pe
Pe
oe
oe
qF
Uh
dA
ho
fn
HP
Fn
Bz
FX
Ys
Ys
em
Ys
DG
EV
EV
EV
EV
EV
EV
EV
Ys
oe
oe
"}
(36,1,1) = {"
Pe
Pe
Pe
Pe
oe
oe
qF
za
Rs
za
ze
Hk
jZ
em
FX
em
em
em
Ys
DG
EV
sl
sl
sl
sl
sl
sl
Ys
oe
oe
"}
(37,1,1) = {"
Pe
Pe
Pe
Pe
oe
oe
qF
UU
Ng
Kz
kI
UI
HH
LU
lu
WF
em
em
Ys
DG
EV
sl
sl
sl
wO
sl
sl
Ys
oe
oe
"}
(38,1,1) = {"
Pe
Pe
Pe
Pe
oe
oe
qF
eI
wx
Dj
Fz
DV
HH
yz
Ai
WF
ls
em
Ys
DG
EV
wO
Uq
sl
sl
sl
sl
Ys
oe
oe
"}
(39,1,1) = {"
Pe
Pe
Pe
Pe
oe
oe
qF
iZ
yH
DP
Ge
NF
jZ
em
em
WF
em
em
Ys
DG
EV
fs
QU
it
sl
fs
sl
Ys
oe
oe
"}
(40,1,1) = {"
Pe
Pe
Pe
Pe
Ys
Ys
qF
qF
qF
jZ
jZ
jZ
qF
em
em
em
em
em
Ys
EV
EV
sl
QU
AB
sl
sl
sl
Ys
oe
oe
"}
(41,1,1) = {"
Pe
Pe
Pe
Pe
Ys
em
em
em
em
em
YG
em
em
em
em
nS
em
em
Nd
EV
EV
sl
ON
RY
dZ
fs
sl
Ys
oe
oe
"}
(42,1,1) = {"
Pe
Pe
Pe
Pe
Ys
em
em
em
Ys
Ys
Ys
Ys
Ys
Ys
Ys
Ys
Ys
Ys
Ys
Ys
Ys
kK
kK
kK
kK
Ys
Ys
Ys
oe
oe
"}
(43,1,1) = {"
Pe
Pe
Pe
Pe
Ys
em
em
em
Ys
oe
oe
oe
oe
oe
oe
oe
oe
oe
oe
oe
oe
oe
oe
oe
oe
oe
oe
oe
oe
oe
"}
(44,1,1) = {"
Pe
Pe
Pe
Pe
Ys
em
em
em
Ys
oe
oe
oe
oe
oe
oe
oe
oe
oe
oe
oe
oe
oe
oe
oe
oe
oe
oe
oe
oe
oe
"}
(45,1,1) = {"
Pe
Pe
Pe
Pe
Ys
em
em
em
Ys
Pe
Pe
Pe
Pe
Pe
Pe
Pe
Pe
Pe
Pe
Pe
Pe
Pe
Pe
Pe
Pe
Pe
Pe
Pe
Pe
Pe
"}
