//MAP CONVERTED BY dmm2tgm.py THIS HEADER COMMENT PREVENTS RECONVERSION, DO NOT REMOVE
"ad" = (
/turf/open/floor/plating,
/area/maintenance/central/frozen/upper)
"ah" = (
/obj/machinery/atmospherics/pipe/simple/multiz{
	dir = 8;
	piping_layer = 3
	},
/turf/open/floor/plating/snowed/smoothed/warmer,
/area/maintenance/central/frozen/upper)
"ap" = (
/turf/closed/mineral/random/snow,
/area/icemoon/underground/unexplored/rivers)
"au" = (
/obj/structure/disposalpipe/segment,
/obj/structure/cable{
	icon_state = "4-8"
	},
/turf/open/floor/plating/snowed/smoothed/warmer,
/area/maintenance/central/frozen/upper)
"bt" = (
/obj/machinery/door/window/northleft{
	dir = 8;
	name = "Atmos Monitoring";
	req_access_txt = "12; 24"
	},
/obj/machinery/atmospherics/pipe/simple/supply/hidden{
	dir = 4
	},
/obj/structure/cable{
	icon_state = "4-8"
	},
/obj/structure/cable{
	icon_state = "2-4"
	},
/turf/open/floor/plating,
/area/engineering/substation/service/lower)
"bF" = (
/obj/machinery/atmospherics/pipe/simple/scrubbers/hidden/layer3{
	dir = 4
	},
/obj/machinery/atmospherics/pipe/simple/supply/hidden/layer1{
	dir = 4
	},
/turf/open/floor/plating/snowed/smoothed/warmer,
/area/maintenance/central/frozen/upper)
"bT" = (
/obj/machinery/atmospherics/pipe/simple/supply/hidden/layer1,
/turf/open/floor/plating/snowed/smoothed/warmer,
/area/maintenance/central/frozen/upper)
"bZ" = (
/obj/structure/chair/sofa/left,
/turf/open/floor/plating/snowed/smoothed/warmer,
/area/maintenance/central/frozen/upper)
"cK" = (
/obj/effect/mapping_helpers/airlock/cyclelink_helper,
/obj/machinery/door/airlock/external{
	name = "External Access";
	req_access_txt = "13"
	},
/turf/open/floor/plating,
/area/maintenance/central/frozen/upper)
"du" = (
/obj/effect/spawner/lootdrop/maintenance,
/turf/open/floor/plating/snowed/smoothed/warmer,
/area/maintenance/central/frozen/upper)
"eq" = (
/obj/machinery/atmospherics/pipe/manifold/supply/hidden{
	dir = 8
	},
/turf/open/floor/plating,
/area/engineering/substation/service/lower)
"fe" = (
/mob/living/simple_animal/pet/penguin/baby,
/turf/open/floor/plating/ice/temperate,
/area/maintenance/central/frozen/upper)
"fp" = (
/obj/structure/disposalpipe/segment{
	dir = 9
	},
/obj/machinery/atmospherics/pipe/simple/scrubbers/hidden/layer3{
	dir = 4
	},
/obj/machinery/atmospherics/pipe/simple/supply/hidden/layer1{
	dir = 4
	},
/turf/open/floor/plating/snowed/smoothed/warmer,
/area/maintenance/central/frozen/upper)
"ga" = (
/obj/machinery/light{
	dir = 8
	},
/obj/structure/disposalpipe/segment{
	dir = 4
	},
/turf/open/floor/plasteel,
/area/engineering/substation/service/lower)
"gk" = (
/obj/effect/spawner/structure/window/reinforced,
/obj/structure/disposalpipe/segment{
	dir = 4
	},
/turf/open/floor/plating,
/area/engineering/substation/service/lower)
"gm" = (
/obj/structure/window/spawner,
/turf/open/floor/plating/ice/temperate,
/area/maintenance/central/frozen/upper)
"gA" = (
/obj/structure/disposalpipe/segment{
	dir = 1
	},
/turf/open/floor/plating/snowed/smoothed/warmer,
/area/maintenance/central/frozen/upper)
"hh" = (
/obj/structure/cable{
	icon_state = "1-8"
	},
/turf/open/floor/plating/snowed/smoothed/warmer,
/area/maintenance/central/frozen/upper)
"hF" = (
/turf/closed/wall/mineral/snow,
/area/maintenance/central/frozen/upper)
"iu" = (
/obj/structure/disposalpipe/segment{
	dir = 5
	},
/obj/machinery/atmospherics/pipe/simple/scrubbers/hidden/layer3{
	dir = 5
	},
/obj/machinery/atmospherics/pipe/simple/supply/hidden/layer1{
	dir = 5
	},
/turf/open/floor/plating/snowed/smoothed/warmer,
/area/maintenance/central/frozen/upper)
"jB" = (
/obj/structure/table/wood,
/obj/item/toy/fluff/bone_poly/squeak,
/turf/open/floor/plating/snowed/smoothed/warmer,
/area/maintenance/central/frozen/upper)
"jT" = (
/obj/structure/chair/sofa{
	dir = 4
	},
/turf/open/floor/plating/snowed/smoothed/warmer,
/area/maintenance/central/frozen/upper)
"kD" = (
/obj/machinery/atmospherics/components/unary/vent_scrubber/on{
	dir = 4
	},
/obj/structure/disposalpipe/segment{
	dir = 4
	},
/turf/open/floor/plasteel,
/area/engineering/substation/service/lower)
"kU" = (
/obj/machinery/deepfryer,
/turf/open/floor/plating/snowed/smoothed/warmer,
/area/maintenance/central/frozen/upper)
"ll" = (
/obj/machinery/atmospherics/components/binary/valve/digital/on{
	name = "Digital Valve"
	},
/obj/structure/disposalpipe/segment{
	dir = 4
	},
/turf/open/floor/plating,
/area/engineering/substation/service/lower)
"lK" = (
/obj/structure/disposalpipe/segment{
	dir = 6
	},
/turf/open/floor/plating/snowed/smoothed/warmer,
/area/maintenance/central/frozen/upper)
"lT" = (
/obj/machinery/atmospherics/pipe/simple/scrubbers/hidden/layer3{
	dir = 9
	},
/obj/machinery/atmospherics/pipe/simple/supply/hidden/layer1{
	dir = 4
	},
/turf/open/floor/plating/snowed/smoothed/warmer,
/area/maintenance/central/frozen/upper)
"mc" = (
/obj/structure/disposalpipe/segment{
	dir = 4
	},
/obj/machinery/atmospherics/pipe/simple/supply/hidden/layer1{
	dir = 4
	},
/obj/machinery/atmospherics/pipe/simple/scrubbers/hidden/layer3{
	dir = 4
	},
/obj/effect/spawner/lootdrop/tool_box,
/turf/open/floor/plating/snowed/smoothed/warmer,
/area/maintenance/central/frozen/upper)
"mk" = (
/obj/structure/disposalpipe/segment{
	dir = 4
	},
/turf/open/floor/plating/snowed/smoothed/warmer,
/area/maintenance/central/frozen/upper)
"mF" = (
/obj/structure/disposalpipe/trunk/multiz/down,
/obj/machinery/atmospherics/pipe/simple/scrubbers/hidden/layer3{
	dir = 1
	},
/obj/machinery/atmospherics/pipe/simple/supply/hidden/layer1{
	dir = 6
	},
/turf/open/floor/plating/snowed/smoothed/warmer,
/area/maintenance/central/frozen/upper)
"mK" = (
/obj/machinery/power/deck_relay,
/obj/structure/cable{
	icon_state = "0-2"
	},
/turf/open/floor/plating/snowed/smoothed/warmer,
/area/maintenance/central/frozen/upper)
"pA" = (
/obj/structure/cable{
	icon_state = "4-8"
	},
/obj/structure/disposalpipe/segment{
	dir = 4
	},
/obj/machinery/door/window/westleft,
/turf/open/floor/plating/ice/temperate,
/area/maintenance/central/frozen/upper)
"pB" = (
/obj/effect/spawner/structure/window/reinforced,
/turf/open/floor/plating,
/area/engineering/substation/service/lower)
"pI" = (
/obj/structure/cable{
	icon_state = "4-8"
	},
/obj/structure/disposalpipe/segment{
	dir = 4
	},
/turf/open/floor/plasteel,
/area/engineering/substation/service/lower)
"pM" = (
/turf/closed/wall/r_wall,
/area/engineering/substation/service/lower)
"pS" = (
/obj/structure/disposalpipe/segment,
/turf/open/floor/plating/snowed/smoothed/warmer,
/area/maintenance/central/frozen/upper)
"ql" = (
/obj/structure/window/spawner/north,
/turf/open/floor/plating/ice/temperate,
/area/maintenance/central/frozen/upper)
"qq" = (
/obj/structure/cable{
	icon_state = "4-8"
	},
/obj/structure/disposalpipe/segment{
	dir = 4
	},
/obj/effect/spawner/lootdrop/maintenance,
/turf/open/floor/plating/ice/temperate,
/area/maintenance/central/frozen/upper)
"rv" = (
/obj/structure/cable{
	icon_state = "4-8"
	},
/turf/open/floor/plating/snowed/smoothed/warmer,
/area/maintenance/central/frozen/upper)
"rT" = (
/obj/structure/table,
/obj/item/reagent_containers/food/snacks/chilicheesefries,
/turf/open/floor/plating/snowed/smoothed/warmer,
/area/maintenance/central/frozen/upper)
"sH" = (
/obj/structure/disposalpipe/segment{
	dir = 4
	},
/obj/machinery/atmospherics/pipe/simple/supply/hidden/layer1{
	dir = 4
	},
/obj/machinery/atmospherics/pipe/simple/scrubbers/hidden/layer3{
	dir = 4
	},
/obj/effect/spawner/lootdrop/low_tools,
/turf/open/floor/plating/snowed/smoothed/warmer,
/area/maintenance/central/frozen/upper)
"tC" = (
/obj/structure/table/wood,
/turf/open/floor/plating/snowed/smoothed/warmer,
/area/maintenance/central/frozen/upper)
"tP" = (
/obj/structure/window/reinforced{
	dir = 8
	},
/obj/machinery/atmospherics/pipe/simple/multiz,
/obj/structure/cable{
	icon_state = "1-2"
	},
/turf/open/floor/plating,
/area/engineering/substation/service/lower)
"uY" = (
/obj/structure/cable{
	icon_state = "0-4"
	},
/obj/machinery/camera{
	c_tag = "Southern Engineering Post"
	},
/obj/machinery/power/apc{
	areastring = "/area/engineering/substation/service/lower";
	name = "Lower East Engineering Post APC";
	pixel_x = -24
	},
/turf/open/floor/plasteel,
/area/engineering/substation/service/lower)
"vE" = (
/obj/structure/cable{
	icon_state = "4-8"
	},
/obj/structure/disposalpipe/segment{
	dir = 4
	},
/obj/effect/spawner/lootdrop/glowstick,
/turf/open/floor/plating/snowed/smoothed/warmer,
/area/maintenance/central/frozen/upper)
"wa" = (
/obj/machinery/light/floor,
/obj/structure/cable{
	icon_state = "1-4"
	},
/obj/structure/railing{
	dir = 1
	},
/turf/open/floor/plating/snowed/smoothed/warmer,
/area/maintenance/central/frozen/upper)
"wo" = (
/obj/structure/window/spawner/east,
/obj/structure/window/spawner,
/turf/open/floor/plating/ice/temperate,
/area/maintenance/central/frozen/upper)
"xb" = (
/obj/structure/disposalpipe/trunk/multiz/down{
	dir = 1
	},
/obj/machinery/atmospherics/pipe/simple/scrubbers/hidden/layer3{
	dir = 6
	},
/turf/open/floor/plating/snowed/smoothed/warmer,
/area/maintenance/central/frozen/upper)
"xM" = (
/obj/structure/window/spawner/east,
/obj/structure/window/spawner/north,
/turf/open/floor/plating/ice/temperate,
/area/maintenance/central/frozen/upper)
"yb" = (
/obj/machinery/camera{
	c_tag = "Northwestern Engineering Post";
	dir = 1
	},
/obj/machinery/light,
/obj/structure/disposalpipe/trunk/multiz{
	dir = 8
	},
/turf/open/floor/plating,
/area/engineering/substation/service/lower)
"yN" = (
/obj/machinery/atmospherics/pipe/simple/supply/hidden/layer1{
	dir = 9
	},
/obj/effect/spawner/lootdrop/glowstick,
/turf/open/floor/plating/snowed/smoothed/warmer,
/area/maintenance/central/frozen/upper)
"zF" = (
/obj/structure/disposalpipe/segment{
	dir = 4
	},
/obj/machinery/atmospherics/pipe/simple/supply/hidden/layer1{
	dir = 4
	},
/obj/machinery/atmospherics/pipe/simple/scrubbers/hidden/layer3{
	dir = 4
	},
/obj/machinery/door/window/eastleft,
/turf/open/floor/plating/ice/temperate,
/area/maintenance/central/frozen/upper)
"Ap" = (
/turf/open/floor/plating/ice/temperate,
/area/maintenance/central/frozen/upper)
"Bu" = (
/obj/machinery/atmospherics/pipe/simple/multiz{
	dir = 8;
	piping_layer = 1
	},
/turf/open/floor/plating/snowed/smoothed/warmer,
/area/maintenance/central/frozen/upper)
"BM" = (
/turf/open/floor/carpet/arcade,
/area/maintenance/central/frozen/upper)
"Ce" = (
/obj/machinery/door/window/westright,
/turf/open/floor/plating/snowed/smoothed/warmer,
/area/maintenance/central/frozen/upper)
"CA" = (
/obj/structure/window/spawner/north,
/obj/structure/window/spawner/west,
/turf/open/floor/plating/ice/temperate,
/area/maintenance/central/frozen/upper)
"CG" = (
/obj/structure/cable{
	icon_state = "4-8"
	},
/obj/structure/disposalpipe/segment{
	dir = 4
	},
/turf/open/floor/plating/ice/temperate,
/area/maintenance/central/frozen/upper)
"CZ" = (
/obj/structure/disposalpipe/trunk/multiz{
	dir = 8
	},
/turf/open/floor/plating,
/area/engineering/substation/service/lower)
"DJ" = (
/obj/machinery/atmospherics/pipe/simple/supply/hidden{
	dir = 10
	},
/obj/structure/cable{
	icon_state = "4-8"
	},
/turf/open/floor/plating,
/area/engineering/substation/service/lower)
"Ek" = (
/obj/effect/spawner/structure/window/reinforced,
/obj/machinery/atmospherics/pipe/layer_manifold,
/turf/open/floor/plating,
/area/engineering/substation/service/lower)
"Ep" = (
/obj/structure/window/spawner/west,
/obj/structure/window/spawner,
/turf/open/floor/plating/ice/temperate,
/area/maintenance/central/frozen/upper)
"ER" = (
/obj/machinery/door/airlock/atmos/abandoned{
	name = "Atmospherics Maintenance";
	req_access_txt = "12;24"
	},
/obj/structure/cable{
	icon_state = "1-2"
	},
/turf/open/floor/plasteel,
/area/engineering/substation/service/lower)
"EZ" = (
/obj/structure/cable{
	icon_state = "4-8"
	},
/obj/machinery/light/floor,
/obj/structure/disposalpipe/segment{
	dir = 4
	},
/turf/open/floor/plating/ice/temperate,
/area/maintenance/central/frozen/upper)
"FB" = (
/obj/structure/table,
/turf/open/floor/plating/snowed/smoothed/warmer,
/area/maintenance/central/frozen/upper)
"FI" = (
/obj/structure/cable{
	icon_state = "4-8"
	},
/obj/machinery/atmospherics/components/unary/vent_pump/on{
	dir = 4
	},
/turf/open/floor/plasteel,
/area/engineering/substation/service/lower)
"FR" = (
/obj/structure/cable{
	icon_state = "4-8"
	},
/obj/structure/disposalpipe/segment{
	dir = 4
	},
/turf/open/floor/plating/snowed/smoothed/warmer,
/area/maintenance/central/frozen/upper)
"Gq" = (
/obj/structure/window/spawner/west,
/turf/open/floor/plating/ice/temperate,
/area/maintenance/central/frozen/upper)
"GO" = (
/obj/structure/window/spawner/east,
/turf/open/floor/plating/ice/temperate,
/area/maintenance/central/frozen/upper)
"GP" = (
/obj/structure/window/reinforced{
	dir = 8
	},
/turf/open/floor/plating,
/area/engineering/substation/service/lower)
"GZ" = (
/obj/structure/cable{
	icon_state = "1-8"
	},
/turf/open/floor/plating,
/area/engineering/substation/service/lower)
"Hs" = (
/obj/structure/railing{
	dir = 1
	},
/obj/effect/spawner/lootdrop/grille_or_trash,
/turf/open/floor/plating/snowed/smoothed/warmer,
/area/maintenance/central/frozen/upper)
"Hx" = (
/obj/structure/cable{
	icon_state = "4-8"
	},
/obj/machinery/light/floor,
/obj/structure/disposalpipe/segment{
	dir = 4
	},
/turf/open/floor/plating/snowed/smoothed/warmer,
/area/maintenance/central/frozen/upper)
"HV" = (
/obj/effect/spawner/lootdrop/druggie_pill,
/turf/open/floor/plating/snowed/smoothed/warmer,
/area/maintenance/central/frozen/upper)
"IE" = (
/obj/effect/spawner/lootdrop/tool_box,
/turf/open/floor/plating/snowed/smoothed/warmer,
/area/maintenance/central/frozen/upper)
"IN" = (
/obj/effect/mapping_helpers/airlock/cyclelink_helper{
	dir = 1
	},
/obj/machinery/door/airlock/external{
	name = "External Access";
	req_access_txt = "13"
	},
/obj/structure/fans/tiny,
/turf/open/floor/plating,
/area/maintenance/central/frozen/upper)
"Jq" = (
/obj/structure/disposalpipe/segment{
	dir = 4
	},
/obj/machinery/atmospherics/pipe/simple/supply/hidden/layer1{
	dir = 4
	},
/obj/machinery/atmospherics/pipe/simple/scrubbers/hidden/layer3{
	dir = 4
	},
/turf/open/floor/plating/ice/temperate,
/area/maintenance/central/frozen/upper)
"JD" = (
/obj/structure/cable{
	icon_state = "2-4"
	},
/obj/structure/disposalpipe/segment{
	dir = 4
	},
/turf/open/floor/plasteel,
/area/engineering/substation/service/lower)
"Kd" = (
/obj/structure/disposalpipe/segment{
	dir = 4
	},
/obj/machinery/atmospherics/pipe/simple/supply/hidden/layer1{
	dir = 4
	},
/obj/machinery/atmospherics/pipe/simple/scrubbers/hidden/layer3{
	dir = 4
	},
/turf/open/floor/plating/snowed/smoothed/warmer,
/area/maintenance/central/frozen/upper)
"Km" = (
/obj/structure/cable{
	icon_state = "4-8"
	},
/obj/structure/disposalpipe/segment{
	dir = 5
	},
/obj/structure/railing{
	dir = 1
	},
/turf/open/floor/plating/snowed/smoothed/warmer,
/area/maintenance/central/frozen/upper)
"Ld" = (
/obj/effect/spawner/lootdrop/trashbin,
/turf/open/floor/plating/snowed/smoothed/warmer,
/area/maintenance/central/frozen/upper)
"Ly" = (
/obj/structure/chair/sofa/corner{
	dir = 4
	},
/turf/open/floor/plating/snowed/smoothed/warmer,
/area/maintenance/central/frozen/upper)
"Mv" = (
/obj/structure/disposalpipe/segment{
	dir = 9
	},
/obj/structure/cable{
	icon_state = "4-8"
	},
/turf/open/floor/plating/snowed/smoothed/warmer,
/area/maintenance/central/frozen/upper)
"MF" = (
/obj/machinery/atmospherics/pipe/simple/multiz{
	dir = 8
	},
/turf/open/floor/plating,
/area/engineering/substation/service/lower)
"ML" = (
/obj/structure/table,
/obj/item/reagent_containers/food/snacks/hotdog{
	desc = "Wow, they have it! GLIZZY!";
	name = "glizzy"
	},
/turf/open/floor/plating/snowed/smoothed/warmer,
/area/maintenance/central/frozen/upper)
"MW" = (
/obj/structure/disposalpipe/segment{
	dir = 4
	},
/obj/machinery/atmospherics/pipe/simple/supply/hidden/layer1{
	dir = 4
	},
/obj/machinery/atmospherics/pipe/simple/scrubbers/hidden/layer3{
	dir = 4
	},
/obj/machinery/door/window/westright,
/turf/open/floor/plating/ice/temperate,
/area/maintenance/central/frozen/upper)
"Nv" = (
/obj/machinery/atmospherics/pipe/simple/supply/hidden,
/obj/structure/disposalpipe/segment{
	dir = 4
	},
/turf/open/floor/plating,
/area/engineering/substation/service/lower)
"OJ" = (
/obj/structure/window/spawner/west,
/obj/machinery/computer/arcade{
	dir = 4
	},
/turf/open/floor/carpet/arcade,
/area/maintenance/central/frozen/upper)
"OP" = (
/turf/open/floor/plating/snowed/smoothed/warmer,
/area/maintenance/central/frozen/upper)
"Pk" = (
/obj/structure/closet/cabinet,
/obj/item/clothing/suit/hooded/wintercoat,
/obj/item/clothing/suit/hooded/wintercoat,
/obj/item/clothing/shoes/winterboots{
	pixel_x = 2;
	pixel_y = -2
	},
/obj/item/clothing/shoes/winterboots{
	pixel_x = 2;
	pixel_y = -2
	},
/turf/open/floor/plating/snowed/smoothed/warmer,
/area/maintenance/central/frozen/upper)
"PK" = (
/obj/structure/bonfire/prelit,
/turf/open/floor/plating/snowed/smoothed/warmer,
/area/maintenance/central/frozen/upper)
"Qi" = (
/turf/closed/mineral/random/snow,
/area/icemoon/surface/outdoors)
"Qj" = (
/obj/item/radio/intercom{
	pixel_x = -30
	},
/turf/open/floor/plasteel,
/area/engineering/substation/service/lower)
"Ql" = (
/obj/structure/cable{
	icon_state = "4-8"
	},
/obj/structure/disposalpipe/segment{
	dir = 4
	},
/obj/machinery/door/window/eastright,
/turf/open/floor/plating/ice/temperate,
/area/maintenance/central/frozen/upper)
"Qw" = (
/obj/structure/window/reinforced{
	dir = 8
	},
/obj/machinery/atmospherics/pipe/manifold/scrubbers/hidden{
	dir = 4
	},
/obj/structure/cable{
	icon_state = "1-2"
	},
/obj/structure/disposalpipe/segment{
	dir = 4
	},
/turf/open/floor/plating,
/area/engineering/substation/service/lower)
"QW" = (
/obj/machinery/atmospherics/pipe/simple/scrubbers/hidden/layer3,
/turf/open/floor/plating/snowed/smoothed/warmer,
/area/maintenance/central/frozen/upper)
"Rz" = (
/obj/structure/disposalpipe/segment,
/obj/machinery/atmospherics/pipe/simple/scrubbers/hidden/layer3{
	dir = 1
	},
/obj/machinery/atmospherics/pipe/simple/supply/hidden/layer1,
/obj/structure/railing{
	dir = 1
	},
/turf/open/floor/plating/snowed/smoothed/warmer,
/area/maintenance/central/frozen/upper)
"RS" = (
/obj/effect/spawner/structure/window/reinforced,
/turf/open/floor/plating/snowed/smoothed/warmer,
/area/maintenance/central/frozen/upper)
"RW" = (
/turf/open/openspace,
/area/maintenance/central/frozen/upper)
"SE" = (
/obj/structure/disposalpipe/segment{
	dir = 10
	},
/turf/open/floor/plating/snowed/smoothed/warmer,
/area/maintenance/central/frozen/upper)
"SZ" = (
/obj/structure/table/wood,
/obj/item/reagent_containers/food/snacks/meat/steak/penguin,
/turf/open/floor/plating/snowed/smoothed/warmer,
/area/maintenance/central/frozen/upper)
"Tf" = (
/obj/structure/window/reinforced{
	dir = 8
	},
/obj/machinery/atmospherics/pipe/simple/scrubbers/hidden,
/obj/structure/cable{
	icon_state = "1-8"
	},
/obj/structure/disposalpipe/segment{
	dir = 4
	},
/turf/open/floor/plating,
/area/engineering/substation/service/lower)
"Ur" = (
/obj/structure/railing{
	dir = 1
	},
/turf/open/openspace,
/area/maintenance/central/frozen/upper)
"UF" = (
/turf/open/floor/plasteel,
/area/engineering/substation/service/lower)
"UI" = (
/turf/closed/mineral/random/snow,
/area/maintenance/central/frozen/upper)
"Vg" = (
/obj/structure/chair/sofa/right{
	dir = 4
	},
/turf/open/floor/plating/snowed/smoothed/warmer,
/area/maintenance/central/frozen/upper)
"VQ" = (
/obj/structure/window/spawner/east,
/obj/machinery/computer/arcade{
	dir = 8
	},
/turf/open/floor/carpet/arcade,
/area/maintenance/central/frozen/upper)
"VU" = (
/obj/machinery/airalarm/directional/north,
/turf/open/floor/plasteel,
/area/engineering/substation/service/lower)
"Xc" = (
/obj/structure/disposalpipe/segment{
	dir = 5
	},
/turf/open/floor/plating/snowed/smoothed/warmer,
/area/maintenance/central/frozen/upper)
"Xk" = (
/obj/structure/cable{
	icon_state = "4-8"
	},
/obj/structure/disposalpipe/segment{
	dir = 4
	},
/obj/structure/railing/corner{
	dir = 1
	},
/turf/open/floor/plating/snowed/smoothed/warmer,
/area/maintenance/central/frozen/upper)
"Yi" = (
/obj/effect/spawner/lootdrop/maintenance,
/turf/open/floor/plating/ice/temperate,
/area/maintenance/central/frozen/upper)
"Yk" = (
/obj/machinery/power/deck_relay,
/obj/structure/cable{
	icon_state = "0-2"
	},
/turf/open/floor/plating,
/area/engineering/substation/service/lower)
"Ym" = (
/turf/open/floor/plating,
/area/engineering/substation/service/lower)
"Zp" = (
/obj/structure/chair/sofa,
/turf/open/floor/plating/snowed/smoothed/warmer,
/area/maintenance/central/frozen/upper)

(1,1,1) = {"
ap
ap
ap
ap
ap
ap
ap
ap
Qi
Qi
Qi
Qi
Qi
Qi
Qi
Qi
Qi
Qi
ap
ap
ap
ap
ap
ap
ap
ap
ap
ap
ap
ap
"}
(2,1,1) = {"
ap
ap
ap
ap
ap
ap
ap
Qi
Qi
Qi
Qi
Qi
Qi
Qi
Qi
Qi
Qi
Qi
ap
ap
ap
ap
ap
ap
ap
ap
ap
ap
ap
ap
"}
(3,1,1) = {"
ap
ap
ap
ap
ap
ap
ap
Qi
Qi
Qi
hF
hF
hF
hF
hF
hF
Qi
Qi
ap
ap
ap
ap
ap
ap
ap
ap
ap
ap
ap
ap
"}
(4,1,1) = {"
ap
ap
ap
ap
ap
ap
ap
Qi
Qi
hF
hF
OP
Ld
Ur
RW
hF
Qi
Qi
ap
ap
ap
ap
ap
ap
ap
ap
ap
ap
ap
ap
"}
(5,1,1) = {"
ap
ap
ap
ap
ap
ap
ap
Qi
Qi
hF
HV
OP
OP
Ur
RW
hF
Qi
Qi
ap
ap
ap
ap
ap
ap
ap
ap
ap
ap
ap
ap
"}
(6,1,1) = {"
ap
ap
ap
ap
ap
ap
ap
Qi
Qi
hF
lK
xb
mF
Rz
iu
hF
Qi
Qi
ap
ap
ap
ap
ap
ap
ap
ap
ap
ap
ap
ap
"}
(7,1,1) = {"
ap
ap
ap
ap
ap
ap
ap
Qi
Qi
hF
mk
ah
Bu
Hs
Kd
hF
Qi
Qi
ap
ap
ap
ap
ap
ap
ap
ap
ap
ap
ap
ap
"}
(8,1,1) = {"
ap
ap
ap
ap
ap
ap
ap
Qi
Qi
hF
SE
Xc
mK
wa
Kd
hF
Qi
Qi
ap
ap
ap
ap
ap
ap
ap
ap
ap
ap
ap
ap
"}
(9,1,1) = {"
ap
ap
ap
ap
ap
ap
ap
Qi
Qi
hF
hF
SE
gA
Km
Kd
hF
Qi
Qi
ap
ap
ap
ap
ap
ap
ap
ap
ap
ap
ap
ap
"}
(10,1,1) = {"
ap
ap
ap
Qi
Qi
Qi
Qi
Qi
Qi
Qi
hF
hF
hF
Xk
Kd
hF
Qi
Qi
Qi
Qi
Qi
Qi
Qi
Qi
Qi
ap
ap
ap
ap
ap
"}
(11,1,1) = {"
ap
ap
ap
Qi
Qi
Qi
Qi
Qi
Qi
Qi
Qi
Qi
hF
FR
Kd
hF
Qi
Qi
Qi
Qi
Qi
Qi
Qi
Qi
Qi
ap
ap
ap
ap
ap
"}
(12,1,1) = {"
ap
ap
ap
Qi
Qi
hF
hF
hF
hF
hF
hF
hF
hF
vE
Kd
hF
hF
hF
hF
hF
hF
hF
hF
Qi
Qi
ap
ap
ap
ap
ap
"}
(13,1,1) = {"
ap
ap
ap
Qi
Qi
hF
Ly
jT
Vg
OP
OP
OP
OP
FR
Kd
OP
OP
OP
OP
rT
OP
kU
hF
Qi
Qi
ap
ap
ap
ap
ap
"}
(14,1,1) = {"
ap
ap
ap
Qi
Qi
hF
Zp
jB
SZ
OP
OP
OP
OP
FR
Kd
OP
OP
OP
OP
ML
OP
kU
hF
Qi
Qi
ap
ap
ap
ap
ap
"}
(15,1,1) = {"
ap
ap
ap
Qi
Qi
hF
bZ
tC
tC
OP
OP
OP
OP
Hx
sH
OP
OP
OP
OP
FB
OP
OP
hF
Qi
Qi
ap
ap
ap
ap
ap
"}
(16,1,1) = {"
ap
ap
ap
Qi
Qi
hF
OP
OP
OP
OP
OP
CA
Gq
pA
MW
Gq
Ep
OP
OP
FB
FB
Ce
hF
Qi
Qi
ap
ap
ap
ap
ap
"}
(17,1,1) = {"
ap
ap
ap
Qi
Qi
hF
OP
du
OP
OP
CA
Ap
Ap
qq
Jq
Ap
Ap
Ep
OP
OP
OP
OP
hF
Qi
Qi
ap
ap
ap
ap
ap
"}
(18,1,1) = {"
ap
ap
ap
Qi
Qi
hF
OP
OP
OP
CA
Ap
Ap
Ap
CG
Jq
Ap
Ap
Ap
Ep
OP
OP
Ld
hF
Qi
Qi
ap
ap
ap
ap
ap
"}
(19,1,1) = {"
ap
ap
ap
Qi
Qi
hF
Pk
OP
OP
ql
Ap
Ap
Ap
CG
Jq
Ap
Ap
Ap
gm
OP
OP
OP
hF
Qi
Qi
ap
ap
ap
ap
ap
"}
(20,1,1) = {"
ap
Qi
Qi
Qi
Qi
hF
Pk
OP
OP
ql
Ap
Ap
Ap
CG
Jq
Ap
Ap
Ap
gm
OP
OP
OP
hF
Qi
Qi
Qi
Qi
ap
ap
ap
"}
(21,1,1) = {"
ap
Qi
Qi
RS
RS
hF
Pk
OP
OP
ql
Ap
Ap
Ap
CG
Jq
Ap
Ap
Ap
gm
OP
OP
OP
hF
RS
RS
Qi
Qi
ap
ap
ap
"}
(22,1,1) = {"
ap
Qi
Qi
cK
ad
IN
OP
OP
OP
ql
Ap
Ap
fe
EZ
Jq
Ap
Ap
Yi
gm
OP
OP
OP
cK
ad
IN
Qi
Qi
ap
ap
ap
"}
(23,1,1) = {"
ap
Qi
Qi
RS
RS
hF
du
OP
OP
ql
Ap
Ap
Ap
CG
Jq
Ap
Ap
Ap
gm
OP
OP
OP
hF
RS
RS
Qi
Qi
ap
ap
ap
"}
(24,1,1) = {"
ap
Qi
Qi
Qi
Qi
hF
OP
OP
OP
ql
Yi
Ap
Ap
CG
Jq
Ap
Ap
Ap
gm
OP
OP
OP
hF
Qi
Qi
Qi
Qi
ap
ap
ap
"}
(25,1,1) = {"
ap
ap
ap
Qi
Qi
hF
OP
OP
OP
xM
Ap
Ap
Ap
CG
Jq
Ap
Ap
Ap
wo
OP
OP
OP
hF
Qi
Qi
ap
ap
ap
ap
ap
"}
(26,1,1) = {"
ap
ap
ap
Qi
Qi
hF
OP
OP
OP
OP
xM
Ap
Ap
CG
Jq
Ap
Ap
wo
OP
OP
OP
OP
hF
Qi
Qi
ap
ap
ap
ap
ap
"}
(27,1,1) = {"
ap
ap
ap
Qi
Qi
hF
BM
BM
BM
OP
OP
xM
GO
Ql
zF
GO
wo
OP
OP
OP
du
OP
hF
Qi
Qi
ap
ap
ap
ap
ap
"}
(28,1,1) = {"
ap
ap
ap
Qi
Qi
hF
VQ
VQ
VQ
OP
OP
OP
OP
FR
mc
OP
OP
OP
OP
OP
OP
OP
hF
Qi
Qi
ap
ap
ap
ap
ap
"}
(29,1,1) = {"
ap
ap
ap
Qi
Qi
hF
OJ
OJ
OJ
OP
OP
OP
OP
Hx
Kd
du
OP
OP
OP
OP
PK
OP
hF
Qi
Qi
ap
ap
ap
ap
ap
"}
(30,1,1) = {"
ap
ap
ap
Qi
Qi
hF
BM
BM
BM
OP
OP
OP
OP
FR
Kd
OP
OP
OP
OP
OP
OP
OP
hF
Qi
Qi
ap
ap
ap
ap
ap
"}
(31,1,1) = {"
ap
ap
ap
Qi
Qi
hF
hF
hF
hF
hF
hF
hF
hF
FR
Kd
hF
hF
hF
hF
hF
hF
hF
hF
Qi
Qi
ap
ap
ap
ap
ap
"}
(32,1,1) = {"
ap
ap
ap
Qi
Qi
Qi
Qi
UI
hF
OP
lK
pS
pS
Mv
Kd
hF
Qi
Qi
Qi
Qi
Qi
Qi
Qi
Qi
Qi
ap
ap
ap
ap
ap
"}
(33,1,1) = {"
ap
ap
ap
Qi
Qi
Qi
Qi
UI
hF
OP
mk
lK
pS
au
fp
hF
Qi
Qi
Qi
Qi
Qi
Qi
Qi
Qi
Qi
ap
ap
ap
ap
ap
"}
(34,1,1) = {"
ap
ap
ap
ap
Qi
Qi
pM
pM
pM
pM
gk
gk
pB
rv
bF
hF
Qi
Qi
ap
ap
ap
ap
ap
ap
ap
ap
ap
ap
ap
ap
"}
(35,1,1) = {"
ap
ap
ap
ap
Qi
Qi
pM
VU
uY
Qj
ga
JD
ER
hh
bF
hF
Qi
Qi
ap
ap
ap
ap
ap
ap
ap
ap
ap
ap
ap
ap
"}
(36,1,1) = {"
ap
ap
ap
ap
Qi
Qi
pM
UF
FI
UF
kD
pI
pB
OP
bF
hF
Qi
Qi
ap
ap
ap
ap
ap
ap
ap
ap
ap
ap
ap
ap
"}
(37,1,1) = {"
ap
ap
ap
ap
Qi
Qi
pM
GP
bt
tP
Qw
Tf
Ek
QW
lT
hF
Qi
Qi
ap
ap
ap
ap
ap
ap
ap
ap
ap
ap
ap
ap
"}
(38,1,1) = {"
ap
ap
ap
ap
Qi
Qi
pM
Ym
DJ
eq
ll
Nv
Ek
bT
yN
hF
Qi
Qi
ap
ap
ap
ap
ap
ap
ap
ap
ap
ap
ap
ap
"}
(39,1,1) = {"
ap
ap
ap
ap
Qi
Qi
pM
Yk
GZ
MF
CZ
yb
pB
OP
OP
hF
Qi
Qi
ap
ap
ap
ap
ap
ap
ap
ap
ap
ap
ap
ap
"}
(40,1,1) = {"
ap
ap
ap
ap
hF
hF
pM
pM
pM
pB
pB
pB
pM
OP
OP
hF
Qi
Qi
ap
ap
ap
ap
ap
ap
ap
ap
ap
ap
ap
ap
"}
(41,1,1) = {"
ap
ap
ap
ap
hF
OP
OP
OP
OP
OP
IE
OP
OP
OP
OP
hF
Qi
Qi
ap
ap
ap
ap
ap
ap
ap
ap
ap
ap
ap
ap
"}
(42,1,1) = {"
ap
ap
ap
ap
hF
OP
OP
OP
hF
hF
hF
hF
hF
hF
hF
hF
Qi
Qi
ap
ap
ap
ap
ap
ap
ap
ap
ap
ap
ap
ap
"}
(43,1,1) = {"
ap
ap
ap
ap
hF
OP
OP
OP
hF
Qi
Qi
Qi
Qi
Qi
Qi
Qi
Qi
Qi
ap
ap
ap
ap
ap
ap
ap
ap
ap
ap
ap
ap
"}
(44,1,1) = {"
ap
ap
ap
ap
hF
OP
OP
OP
hF
Qi
Qi
Qi
Qi
Qi
Qi
Qi
Qi
Qi
ap
ap
ap
ap
ap
ap
ap
ap
ap
ap
ap
ap
"}
(45,1,1) = {"
ap
ap
ap
ap
hF
OP
OP
OP
hF
ap
ap
ap
ap
ap
ap
ap
ap
ap
ap
ap
ap
ap
ap
ap
ap
ap
ap
ap
ap
ap
"}
