//MAP CONVERTED BY dmm2tgm.py THIS HEADER COMMENT PREVENTS RECONVERSION, DO NOT REMOVE
"aE" = (
/turf/open/floor/glass,
/area/maintenance/central/frozen/upper)
"aG" = (
/obj/effect/spawner/structure/window/ice,
/turf/open/floor/wood/wood_diagonal,
/area/maintenance/central/frozen/upper)
"bi" = (
/obj/structure/disposalpipe/segment{
	dir = 4
	},
/obj/machinery/atmospherics/pipe/simple/supply/hidden/layer1{
	dir = 4
	},
/obj/machinery/atmospherics/pipe/simple/scrubbers/hidden/layer3{
	dir = 4
	},
/obj/effect/spawner/lootdrop/low_tools,
/turf/open/floor/plating/snowed/smoothed/warmer,
/area/maintenance/central/frozen/upper)
"bZ" = (
/obj/structure/cable{
	icon_state = "4-8"
	},
/turf/open/floor/plating/snowed/smoothed/warmer,
/area/maintenance/central/frozen/upper)
"cu" = (
/obj/machinery/power/deck_relay,
/obj/structure/cable{
	icon_state = "0-2"
	},
/turf/open/floor/plating,
/area/engineering/substation/service/lower)
"cI" = (
/obj/effect/spawner/lootdrop/gloves,
/turf/open/floor/plating/snowed/smoothed/warmer,
/area/maintenance/central/frozen/upper)
"cR" = (
/obj/structure/cable{
	icon_state = "1-8"
	},
/turf/open/floor/plating,
/area/engineering/substation/service/lower)
"di" = (
/turf/open/openspace,
/area/maintenance/central/frozen/upper)
"dl" = (
/obj/structure/reagent_dispensers/watertank,
/turf/open/floor/plating/snowed/smoothed/warmer,
/area/maintenance/central/frozen/upper)
"dW" = (
/obj/structure/disposalpipe/trunk/multiz/down{
	dir = 1
	},
/obj/machinery/atmospherics/pipe/simple/scrubbers/hidden/layer3{
	dir = 6
	},
/turf/open/floor/plating/snowed/smoothed/warmer,
/area/maintenance/central/frozen/upper)
"eH" = (
/obj/machinery/atmospherics/pipe/simple/multiz{
	dir = 8;
	piping_layer = 1
	},
/turf/open/floor/plating/snowed/smoothed/warmer,
/area/maintenance/central/frozen/upper)
"eW" = (
/obj/structure/window/reinforced{
	dir = 8
	},
/turf/open/floor/plating,
/area/engineering/substation/service/lower)
"fx" = (
/obj/machinery/atmospherics/components/unary/thermomachine/heater,
/turf/open/floor/plating/snowed/smoothed/warmer,
/area/maintenance/central/frozen/upper)
"fA" = (
/obj/machinery/light/floor,
/obj/structure/cable{
	icon_state = "1-4"
	},
/obj/structure/railing{
	dir = 1
	},
/turf/open/floor/plating/snowed/smoothed/warmer,
/area/maintenance/central/frozen/upper)
"fL" = (
/obj/structure/chair/sofa/corp/corner{
	dir = 1
	},
/turf/open/floor/glass,
/area/maintenance/central/frozen/upper)
"ge" = (
/obj/item/flashlight/lantern{
	icon_state = "lantern-on"
	},
/turf/open/floor/wood/shadow,
/area/maintenance/central/frozen/upper)
"gF" = (
/obj/structure/chair/pew/left{
	dir = 4
	},
/turf/open/floor/wood/wood_large,
/area/maintenance/central/frozen/upper)
"gK" = (
/turf/open/floor/plating,
/area/engineering/substation/service/lower)
"hb" = (
/obj/structure/disposalpipe/trunk/multiz/down,
/obj/machinery/atmospherics/pipe/simple/scrubbers/hidden/layer3{
	dir = 1
	},
/obj/machinery/atmospherics/pipe/simple/supply/hidden/layer1{
	dir = 6
	},
/turf/open/floor/plating/snowed/smoothed/warmer,
/area/maintenance/central/frozen/upper)
"he" = (
/obj/machinery/airalarm/directional/north,
/turf/open/floor/plasteel,
/area/engineering/substation/service/lower)
"hJ" = (
/obj/machinery/atmospherics/pipe/simple/scrubbers/hidden/layer3{
	dir = 9
	},
/obj/machinery/atmospherics/pipe/simple/supply/hidden/layer1{
	dir = 4
	},
/turf/open/floor/plating/snowed/smoothed/warmer,
/area/maintenance/central/frozen/upper)
"hT" = (
/obj/structure/chair/pew{
	dir = 4
	},
/turf/open/floor/wood/wood_large,
/area/maintenance/central/frozen/upper)
"hU" = (
/obj/machinery/atmospherics/pipe/simple/scrubbers/hidden/layer3{
	dir = 4
	},
/obj/machinery/atmospherics/pipe/simple/supply/hidden/layer1{
	dir = 4
	},
/turf/open/floor/plating/snowed/smoothed/warmer,
/area/maintenance/central/frozen/upper)
"ie" = (
/obj/structure/cable{
	icon_state = "4-8"
	},
/obj/structure/disposalpipe/segment{
	dir = 4
	},
/obj/effect/spawner/lootdrop/glowstick,
/turf/open/floor/plating/snowed/smoothed/warmer,
/area/maintenance/central/frozen/upper)
"iL" = (
/obj/machinery/door/airlock/wood,
/turf/open/floor/plating/snowed/smoothed/warmer,
/area/maintenance/central/frozen/upper)
"ko" = (
/obj/effect/spawner/structure/window/reinforced,
/obj/machinery/atmospherics/pipe/layer_manifold,
/turf/open/floor/plating,
/area/engineering/substation/service/lower)
"kM" = (
/obj/effect/spawner/structure/window/ice,
/obj/machinery/atmospherics/pipe/heat_exchanging/junction,
/turf/open/floor/wood/wood_diagonal,
/area/maintenance/central/frozen/upper)
"mP" = (
/turf/open/floor/plasteel,
/area/engineering/substation/service/lower)
"mT" = (
/obj/structure/disposalpipe/segment{
	dir = 9
	},
/obj/machinery/atmospherics/pipe/simple/scrubbers/hidden/layer3{
	dir = 4
	},
/obj/machinery/atmospherics/pipe/simple/supply/hidden/layer1{
	dir = 4
	},
/turf/open/floor/plating/snowed/smoothed/warmer,
/area/maintenance/central/frozen/upper)
"mU" = (
/obj/structure/chair/sofa/corp{
	dir = 1
	},
/turf/open/floor/glass,
/area/maintenance/central/frozen/upper)
"nW" = (
/obj/structure/disposalpipe/segment,
/turf/open/floor/plating/snowed/smoothed/warmer,
/area/maintenance/central/frozen/upper)
"oi" = (
/obj/structure/railing{
	dir = 1
	},
/obj/effect/spawner/lootdrop/grille_or_trash,
/turf/open/floor/plating/snowed/smoothed/warmer,
/area/maintenance/central/frozen/upper)
"pT" = (
/obj/structure/disposalpipe/segment{
	dir = 1
	},
/turf/open/floor/plating/snowed/smoothed/warmer,
/area/maintenance/central/frozen/upper)
"qi" = (
/obj/effect/spawner/structure/window/ice,
/turf/open/floor/wood/shadow,
/area/maintenance/central/frozen/upper)
"qK" = (
/obj/structure/chair/pew{
	dir = 8
	},
/turf/open/floor/wood/wood_large,
/area/maintenance/central/frozen/upper)
"qS" = (
/obj/machinery/door/airlock/maintenance{
	req_access_txt = "12"
	},
/turf/open/floor/plating/snowed/smoothed/warmer,
/area/maintenance/central/frozen/upper)
"rg" = (
/obj/structure/table/wood/fancy/black,
/obj/item/pizzabox/margherita{
	pixel_y = 12
	},
/turf/open/floor/glass,
/area/maintenance/central/frozen/upper)
"rn" = (
/obj/item/flashlight/lantern{
	icon_state = "lantern-on"
	},
/obj/effect/turf_decal/siding/wood{
	dir = 8
	},
/obj/effect/spawner/lootdrop/healing_kits,
/turf/open/floor/wood/wood_diagonal,
/area/maintenance/central/frozen/upper)
"rq" = (
/obj/effect/spawner/lootdrop/druggie_pill,
/turf/open/floor/glass,
/area/maintenance/central/frozen/upper)
"rA" = (
/obj/structure/disposalpipe/segment{
	dir = 10
	},
/turf/open/floor/plating/snowed/smoothed/warmer,
/area/maintenance/central/frozen/upper)
"rJ" = (
/obj/structure/chair/pew/right{
	dir = 8
	},
/turf/open/floor/wood/wood_large,
/area/maintenance/central/frozen/upper)
"sd" = (
/obj/effect/spawner/structure/window/reinforced,
/turf/open/floor/plating,
/area/engineering/substation/service/lower)
"sz" = (
/obj/machinery/atmospherics/pipe/manifold/violet/hidden{
	dir = 1
	},
/turf/open/floor/plating/snowed/smoothed/warmer,
/area/maintenance/central/frozen/upper)
"sU" = (
/obj/structure/cable{
	icon_state = "4-8"
	},
/obj/structure/disposalpipe/segment{
	dir = 4
	},
/obj/structure/railing/corner{
	dir = 1
	},
/turf/open/floor/plating/snowed/smoothed/warmer,
/area/maintenance/central/frozen/upper)
"td" = (
/turf/open/floor/plating/snowed/smoothed/warmer,
/area/maintenance/central/frozen/upper)
"tf" = (
/obj/machinery/atmospherics/pipe/heat_exchanging/simple{
	dir = 4
	},
/turf/open/floor/wood/wood_large,
/area/maintenance/central/frozen/upper)
"ui" = (
/obj/structure/disposalpipe/trunk/multiz{
	dir = 8
	},
/turf/open/floor/plating,
/area/engineering/substation/service/lower)
"uo" = (
/obj/machinery/atmospherics/components/binary/valve/digital/on{
	name = "Digital Valve"
	},
/obj/structure/disposalpipe/segment{
	dir = 4
	},
/turf/open/floor/plating,
/area/engineering/substation/service/lower)
"vG" = (
/obj/structure/chair/sofa/corp/left{
	dir = 4
	},
/obj/effect/spawner/lootdrop/coin,
/turf/open/floor/glass,
/area/maintenance/central/frozen/upper)
"vI" = (
/obj/structure/disposalpipe/segment{
	dir = 5
	},
/turf/open/floor/plating/snowed/smoothed/warmer,
/area/maintenance/central/frozen/upper)
"wp" = (
/obj/machinery/atmospherics/pipe/simple/multiz{
	dir = 8
	},
/turf/open/floor/plating,
/area/engineering/substation/service/lower)
"wr" = (
/obj/structure/chair/sofa/corp/right{
	dir = 8
	},
/turf/open/floor/glass,
/area/maintenance/central/frozen/upper)
"wy" = (
/obj/machinery/atmospherics/pipe/manifold/supply/hidden{
	dir = 8
	},
/turf/open/floor/plating,
/area/engineering/substation/service/lower)
"wN" = (
/obj/structure/cable{
	icon_state = "2-4"
	},
/obj/structure/disposalpipe/segment{
	dir = 4
	},
/turf/open/floor/plasteel,
/area/engineering/substation/service/lower)
"xm" = (
/obj/machinery/light{
	dir = 8
	},
/obj/structure/disposalpipe/segment{
	dir = 4
	},
/turf/open/floor/plasteel,
/area/engineering/substation/service/lower)
"xG" = (
/obj/effect/spawner/structure/window/reinforced,
/obj/structure/disposalpipe/segment{
	dir = 4
	},
/turf/open/floor/plating,
/area/engineering/substation/service/lower)
"zm" = (
/obj/machinery/atmospherics/components/unary/vent_scrubber/on{
	dir = 4
	},
/obj/structure/disposalpipe/segment{
	dir = 4
	},
/turf/open/floor/plasteel,
/area/engineering/substation/service/lower)
"zo" = (
/obj/machinery/door/airlock/atmos/abandoned{
	name = "Atmospherics Maintenance";
	req_access_txt = "12;24"
	},
/obj/structure/cable{
	icon_state = "1-2"
	},
/turf/open/floor/plasteel,
/area/engineering/substation/service/lower)
"zK" = (
/obj/structure/disposalpipe/segment{
	dir = 6
	},
/turf/open/floor/plating/snowed/smoothed/warmer,
/area/maintenance/central/frozen/upper)
"Az" = (
/obj/structure/cable{
	icon_state = "0-4"
	},
/obj/machinery/camera{
	c_tag = "Southern Engineering Post"
	},
/obj/machinery/power/apc{
	areastring = "/area/engineering/substation/service/lower";
	name = "Lower East Engineering Post APC";
	pixel_x = -24
	},
/turf/open/floor/plasteel,
/area/engineering/substation/service/lower)
"AC" = (
/obj/structure/cable{
	icon_state = "4-8"
	},
/obj/structure/disposalpipe/segment{
	dir = 4
	},
/turf/open/floor/plasteel,
/area/engineering/substation/service/lower)
"AQ" = (
/obj/effect/spawner/lootdrop/trashbin,
/turf/open/floor/plating/snowed/smoothed/warmer,
/area/maintenance/central/frozen/upper)
"BC" = (
/obj/machinery/atmospherics/pipe/simple/violet/hidden{
	dir = 4
	},
/turf/open/floor/plating/snowed/smoothed/warmer,
/area/maintenance/central/frozen/upper)
"BO" = (
/obj/item/radio/intercom{
	pixel_x = -30
	},
/turf/open/floor/plasteel,
/area/engineering/substation/service/lower)
"BX" = (
/turf/closed/wall/r_wall,
/area/engineering/substation/service/lower)
"Ch" = (
/obj/item/stack/sheet/mineral/wood/fifty,
/obj/structure/closet/crate/wooden,
/obj/item/reagent_containers/glass/bucket{
	pixel_y = 7
	},
/turf/open/floor/plating/snowed/smoothed/warmer,
/area/maintenance/central/frozen/upper)
"Ck" = (
/obj/structure/window/reinforced{
	dir = 8
	},
/obj/machinery/atmospherics/pipe/manifold/scrubbers/hidden{
	dir = 4
	},
/obj/structure/cable{
	icon_state = "1-2"
	},
/obj/structure/disposalpipe/segment{
	dir = 4
	},
/turf/open/floor/plating,
/area/engineering/substation/service/lower)
"CT" = (
/obj/structure/window/reinforced{
	dir = 8
	},
/obj/machinery/atmospherics/pipe/simple/scrubbers/hidden,
/obj/structure/cable{
	icon_state = "1-8"
	},
/obj/structure/disposalpipe/segment{
	dir = 4
	},
/turf/open/floor/plating,
/area/engineering/substation/service/lower)
"Dx" = (
/obj/structure/disposalpipe/segment,
/obj/machinery/atmospherics/pipe/simple/scrubbers/hidden/layer3{
	dir = 1
	},
/obj/machinery/atmospherics/pipe/simple/supply/hidden/layer1,
/obj/structure/railing{
	dir = 1
	},
/turf/open/floor/plating/snowed/smoothed/warmer,
/area/maintenance/central/frozen/upper)
"DC" = (
/obj/item/flashlight/lantern{
	icon_state = "lantern-on"
	},
/obj/effect/turf_decal/siding/wood{
	dir = 4
	},
/turf/open/floor/wood/wood_diagonal,
/area/maintenance/central/frozen/upper)
"Ge" = (
/obj/machinery/door/window/northleft{
	dir = 8;
	name = "Atmos Monitoring";
	req_access_txt = "12; 24"
	},
/obj/machinery/atmospherics/pipe/simple/supply/hidden{
	dir = 4
	},
/obj/structure/cable{
	icon_state = "4-8"
	},
/obj/structure/cable{
	icon_state = "2-4"
	},
/turf/open/floor/plating,
/area/engineering/substation/service/lower)
"GY" = (
/obj/machinery/camera{
	c_tag = "Northwestern Engineering Post";
	dir = 1
	},
/obj/machinery/light,
/obj/structure/disposalpipe/trunk/multiz{
	dir = 8
	},
/turf/open/floor/plating,
/area/engineering/substation/service/lower)
"HC" = (
/obj/structure/sauna_oven,
/turf/open/floor/wood/wood_large,
/area/maintenance/central/frozen/upper)
"HV" = (
/obj/structure/chair/pew/right{
	dir = 4
	},
/obj/machinery/atmospherics/pipe/heat_exchanging/simple{
	dir = 5
	},
/turf/open/floor/wood/wood_large,
/area/maintenance/central/frozen/upper)
"Ia" = (
/obj/structure/disposalpipe/segment,
/obj/structure/cable{
	icon_state = "4-8"
	},
/turf/open/floor/plating/snowed/smoothed/warmer,
/area/maintenance/central/frozen/upper)
"IQ" = (
/obj/machinery/atmospherics/pipe/manifold/violet/hidden{
	dir = 4
	},
/obj/effect/spawner/lootdrop/keg,
/turf/open/floor/plating/snowed/smoothed/warmer,
/area/maintenance/central/frozen/upper)
"Jv" = (
/obj/machinery/atmospherics/pipe/simple/violet/hidden,
/turf/open/floor/plating/snowed/smoothed/warmer,
/area/maintenance/central/frozen/upper)
"JB" = (
/obj/structure/disposalpipe/segment{
	dir = 9
	},
/obj/structure/cable{
	icon_state = "4-8"
	},
/turf/open/floor/plating/snowed/smoothed/warmer,
/area/maintenance/central/frozen/upper)
"JH" = (
/obj/effect/spawner/lootdrop/tool_box,
/turf/open/floor/plating/snowed/smoothed/warmer,
/area/maintenance/central/frozen/upper)
"Kc" = (
/obj/structure/cable{
	icon_state = "1-8"
	},
/turf/open/floor/plating/snowed/smoothed/warmer,
/area/maintenance/central/frozen/upper)
"KP" = (
/obj/structure/window/reinforced{
	dir = 8
	},
/obj/machinery/atmospherics/pipe/simple/multiz,
/obj/structure/cable{
	icon_state = "1-2"
	},
/turf/open/floor/plating,
/area/engineering/substation/service/lower)
"Lm" = (
/obj/structure/cable{
	icon_state = "4-8"
	},
/obj/machinery/light/floor,
/obj/structure/disposalpipe/segment{
	dir = 4
	},
/turf/open/floor/plating/snowed/smoothed/warmer,
/area/maintenance/central/frozen/upper)
"LT" = (
/obj/structure/cable{
	icon_state = "4-8"
	},
/obj/structure/disposalpipe/segment{
	dir = 4
	},
/obj/effect/spawner/lootdrop/maintenance,
/turf/open/floor/plating/snowed/smoothed/warmer,
/area/maintenance/central/frozen/upper)
"Mo" = (
/turf/open/floor/wood/wood_large,
/area/maintenance/central/frozen/upper)
"MY" = (
/obj/machinery/atmospherics/pipe/simple/supply/hidden,
/obj/structure/disposalpipe/segment{
	dir = 4
	},
/turf/open/floor/plating,
/area/engineering/substation/service/lower)
"Nl" = (
/obj/effect/spawner/lootdrop/druggie_pill,
/turf/open/floor/plating/snowed/smoothed/warmer,
/area/maintenance/central/frozen/upper)
"Ny" = (
/obj/machinery/atmospherics/pipe/simple/supply/hidden{
	dir = 10
	},
/obj/structure/cable{
	icon_state = "4-8"
	},
/turf/open/floor/plating,
/area/engineering/substation/service/lower)
"NY" = (
/obj/structure/cable{
	icon_state = "4-8"
	},
/obj/structure/disposalpipe/segment{
	dir = 4
	},
/turf/open/floor/plating/snowed/smoothed/warmer,
/area/maintenance/central/frozen/upper)
"Ot" = (
/turf/closed/mineral/random/snow,
/area/icemoon/underground/unexplored/rivers)
"OG" = (
/obj/structure/disposalpipe/segment{
	dir = 4
	},
/obj/machinery/atmospherics/pipe/simple/supply/hidden/layer1{
	dir = 4
	},
/obj/machinery/atmospherics/pipe/simple/scrubbers/hidden/layer3{
	dir = 4
	},
/turf/open/floor/plating/snowed/smoothed/warmer,
/area/maintenance/central/frozen/upper)
"PU" = (
/obj/machinery/atmospherics/pipe/simple/supply/hidden/layer1,
/turf/open/floor/plating/snowed/smoothed/warmer,
/area/maintenance/central/frozen/upper)
"QA" = (
/obj/structure/chair/pew/left{
	dir = 8
	},
/obj/machinery/atmospherics/pipe/heat_exchanging/simple{
	dir = 9
	},
/turf/open/floor/wood/wood_large,
/area/maintenance/central/frozen/upper)
"QM" = (
/obj/machinery/atmospherics/pipe/simple/scrubbers/hidden/layer3,
/turf/open/floor/plating/snowed/smoothed/warmer,
/area/maintenance/central/frozen/upper)
"Rh" = (
/obj/structure/cable{
	icon_state = "4-8"
	},
/obj/structure/disposalpipe/segment{
	dir = 5
	},
/obj/structure/railing{
	dir = 1
	},
/turf/open/floor/plating/snowed/smoothed/warmer,
/area/maintenance/central/frozen/upper)
"Rz" = (
/obj/structure/railing{
	dir = 1
	},
/turf/open/openspace,
/area/maintenance/central/frozen/upper)
"RG" = (
/obj/structure/chair/sofa/corp/corner{
	dir = 8
	},
/turf/open/floor/glass,
/area/maintenance/central/frozen/upper)
"SF" = (
/obj/machinery/power/deck_relay,
/obj/structure/cable{
	icon_state = "0-2"
	},
/turf/open/floor/plating/snowed/smoothed/warmer,
/area/maintenance/central/frozen/upper)
"SG" = (
/obj/machinery/atmospherics/pipe/simple/supply/hidden/layer1{
	dir = 9
	},
/obj/effect/spawner/lootdrop/glowstick,
/turf/open/floor/plating/snowed/smoothed/warmer,
/area/maintenance/central/frozen/upper)
"TF" = (
/obj/structure/disposalpipe/segment{
	dir = 5
	},
/obj/machinery/atmospherics/pipe/simple/scrubbers/hidden/layer3{
	dir = 5
	},
/obj/machinery/atmospherics/pipe/simple/supply/hidden/layer1{
	dir = 5
	},
/turf/open/floor/plating/snowed/smoothed/warmer,
/area/maintenance/central/frozen/upper)
"UH" = (
/obj/structure/disposalpipe/segment{
	dir = 4
	},
/obj/machinery/atmospherics/pipe/simple/supply/hidden/layer1{
	dir = 4
	},
/obj/machinery/atmospherics/pipe/simple/scrubbers/hidden/layer3{
	dir = 4
	},
/obj/effect/spawner/lootdrop/tool_box,
/turf/open/floor/plating/snowed/smoothed/warmer,
/area/maintenance/central/frozen/upper)
"Vf" = (
/obj/machinery/atmospherics/pipe/simple/multiz{
	dir = 8;
	piping_layer = 3
	},
/turf/open/floor/plating/snowed/smoothed/warmer,
/area/maintenance/central/frozen/upper)
"Wf" = (
/obj/structure/cable{
	icon_state = "4-8"
	},
/obj/machinery/atmospherics/components/unary/vent_pump/on{
	dir = 4
	},
/turf/open/floor/plasteel,
/area/engineering/substation/service/lower)
"WA" = (
/obj/machinery/portable_atmospherics/canister/water_vapor,
/obj/machinery/atmospherics/components/unary/portables_connector/visible{
	dir = 1
	},
/turf/open/floor/plating/snowed/smoothed/warmer,
/area/maintenance/central/frozen/upper)
"Yi" = (
/turf/closed/mineral/random/snow,
/area/icemoon/surface/outdoors)
"Yp" = (
/obj/structure/disposalpipe/segment{
	dir = 4
	},
/turf/open/floor/plating/snowed/smoothed/warmer,
/area/maintenance/central/frozen/upper)
"YA" = (
/obj/effect/spawner/structure/window/ice,
/turf/open/floor/plating/snowed/smoothed/warmer,
/area/maintenance/central/frozen/upper)
"YO" = (
/obj/machinery/door/airlock/maintenance{
	req_access_txt = "12"
	},
/turf/open/floor/wood/shadow,
/area/maintenance/central/frozen/upper)
"ZP" = (
/turf/closed/wall/mineral/snow,
/area/maintenance/central/frozen/upper)
"ZR" = (
/obj/machinery/atmospherics/pipe/simple/violet/hidden{
	dir = 6
	},
/turf/open/floor/plating/snowed/smoothed/warmer,
/area/maintenance/central/frozen/upper)

(1,1,1) = {"
Ot
Ot
Ot
Ot
Ot
Ot
Ot
Ot
Yi
Yi
Yi
Yi
Yi
Yi
Yi
Yi
Yi
Yi
Ot
Ot
Ot
Ot
Ot
Ot
Ot
Ot
Ot
Ot
Ot
Ot
"}
(2,1,1) = {"
Ot
Ot
Ot
Ot
Ot
Ot
Ot
Ot
Yi
Yi
Yi
Yi
Yi
Yi
Yi
Yi
Yi
Yi
Ot
Ot
Ot
Ot
Ot
Ot
Ot
Ot
Ot
Ot
Ot
Ot
"}
(3,1,1) = {"
Ot
Ot
Ot
Ot
Ot
Ot
Ot
Yi
Yi
Yi
YA
YA
YA
YA
YA
YA
Yi
Yi
Ot
Ot
Ot
Ot
Ot
Ot
Ot
Ot
Ot
Ot
Ot
Ot
"}
(4,1,1) = {"
Ot
Ot
Ot
Ot
Ot
Ot
Ot
Yi
Yi
YA
YA
td
AQ
Rz
di
YA
Yi
Yi
Ot
Ot
Ot
Ot
Ot
Ot
Ot
Ot
Ot
Ot
Ot
Ot
"}
(5,1,1) = {"
Ot
Ot
Ot
Ot
Ot
Ot
Ot
Yi
Yi
YA
Nl
td
td
Rz
di
YA
Yi
Yi
Ot
Ot
Ot
Ot
Ot
Ot
Ot
Ot
Ot
Ot
Ot
Ot
"}
(6,1,1) = {"
Ot
Ot
Ot
Ot
Ot
Ot
Ot
Yi
Yi
YA
zK
dW
hb
Dx
TF
YA
Yi
Yi
Ot
Ot
Ot
Ot
Ot
Ot
Ot
Ot
Ot
Ot
Ot
Ot
"}
(7,1,1) = {"
Ot
Ot
Ot
Ot
Ot
Ot
Ot
Yi
Yi
YA
Yp
Vf
eH
oi
OG
YA
Yi
Yi
Ot
Ot
Ot
Ot
Ot
Ot
Ot
Ot
Ot
Ot
Ot
Ot
"}
(8,1,1) = {"
Ot
Ot
Ot
Ot
Ot
Ot
Ot
Yi
Yi
YA
rA
vI
SF
fA
OG
YA
Yi
Yi
Ot
Ot
Ot
Ot
qi
qi
qi
Ot
Ot
Ot
Ot
Ot
"}
(9,1,1) = {"
Ot
Ot
Ot
Ot
Ot
Ot
Ot
Yi
Yi
YA
YA
rA
pT
Rh
OG
YA
Yi
Yi
Ot
Ot
Ot
qi
qi
ge
qi
qi
Ot
Ot
Ot
Ot
"}
(10,1,1) = {"
Ot
Ot
Ot
Ot
Ot
Ot
Ot
Yi
Yi
Yi
YA
YA
YA
sU
OG
YA
YA
YA
YA
YA
YA
qi
aE
vG
fL
qi
qi
Ot
Ot
Ot
"}
(11,1,1) = {"
Ot
Ot
Ot
Ot
Ot
Ot
Ot
Ot
Yi
Yi
Yi
Yi
YA
NY
OG
qS
td
td
td
td
td
YO
aE
rg
mU
ge
qi
Ot
Ot
Ot
"}
(12,1,1) = {"
Ot
Ot
Ot
Ot
Ot
Ot
Ot
Ot
Yi
Yi
Yi
Yi
YA
ie
OG
YA
YA
YA
YA
YA
YA
qi
rq
wr
RG
qi
qi
Ot
Ot
Ot
"}
(13,1,1) = {"
Ot
Ot
Ot
Ot
Ot
Ot
Ot
Ot
Ot
Ot
Yi
Yi
YA
NY
OG
YA
Yi
Yi
Ot
Ot
Ot
qi
qi
ge
qi
qi
Ot
Ot
Ot
Ot
"}
(14,1,1) = {"
Ot
Ot
Ot
Ot
Ot
Ot
Ot
Ot
Ot
Ot
Yi
Yi
YA
NY
OG
YA
Yi
Yi
Ot
Ot
Ot
Ot
qi
qi
qi
Ot
Ot
Ot
Ot
Ot
"}
(15,1,1) = {"
Ot
Ot
Ot
Ot
Ot
Ot
Ot
Ot
Ot
Ot
Yi
Yi
YA
Lm
bi
YA
Yi
Yi
Ot
Ot
Ot
Ot
Ot
Ot
Ot
Ot
Ot
Ot
Ot
Ot
"}
(16,1,1) = {"
Ot
Ot
Ot
Ot
Ot
Ot
Ot
Ot
Ot
Ot
Yi
Yi
YA
NY
OG
YA
Yi
Yi
Ot
Ot
Ot
Ot
Ot
Ot
Ot
Ot
Ot
Ot
Ot
Ot
"}
(17,1,1) = {"
Ot
Ot
Ot
Ot
Ot
Ot
Ot
Ot
Ot
Ot
Yi
Yi
YA
LT
OG
YA
Yi
Yi
Ot
Ot
Ot
Ot
Ot
Ot
Ot
Ot
Ot
Ot
Ot
Ot
"}
(18,1,1) = {"
Ot
Ot
Ot
Ot
Ot
Ot
Ot
Ot
Ot
Ot
Yi
Yi
YA
NY
OG
YA
Yi
Yi
Ot
Ot
Ot
Ot
Ot
Ot
Ot
Ot
Ot
Ot
Ot
Ot
"}
(19,1,1) = {"
Ot
Ot
Ot
Ot
Ot
Ot
Ot
Ot
Ot
Ot
Yi
Yi
YA
NY
OG
YA
Yi
Yi
Ot
Ot
Ot
Ot
Ot
Ot
Ot
Ot
Ot
Ot
Ot
Ot
"}
(20,1,1) = {"
Ot
Ot
Ot
Ot
Ot
Ot
Ot
Ot
Ot
Ot
Yi
Yi
YA
NY
OG
YA
Yi
Yi
Ot
Ot
Ot
Ot
Ot
Ot
Ot
Ot
Ot
Ot
Ot
Ot
"}
(21,1,1) = {"
Ot
Ot
Ot
Ot
Ot
Ot
Ot
Ot
Ot
Ot
Yi
Yi
YA
NY
OG
YA
Yi
Yi
Ot
Ot
Ot
Ot
Ot
Ot
Ot
Ot
Ot
Ot
Ot
Ot
"}
(22,1,1) = {"
Ot
Ot
Ot
Ot
Ot
Ot
Ot
Ot
Ot
Ot
Yi
Yi
YA
Lm
OG
YA
Yi
Yi
Ot
Ot
Ot
Ot
Ot
Ot
Ot
Ot
Ot
Ot
Ot
Ot
"}
(23,1,1) = {"
Ot
Ot
Ot
Ot
Ot
Ot
Ot
Ot
Ot
Ot
Yi
Yi
YA
NY
OG
YA
Yi
Yi
Ot
Ot
Ot
Ot
Ot
Ot
Ot
Ot
Ot
Ot
Ot
Ot
"}
(24,1,1) = {"
Ot
Ot
Ot
Ot
Ot
Ot
Ot
Ot
Ot
Ot
Yi
Yi
YA
NY
OG
YA
Yi
Yi
Ot
Ot
Ot
Ot
Ot
Ot
Ot
Ot
Ot
Ot
Ot
Ot
"}
(25,1,1) = {"
Ot
Ot
Ot
Ot
Ot
Ot
Ot
Ot
Ot
Ot
Yi
Yi
YA
NY
OG
YA
Yi
Yi
Ot
Ot
Ot
Ot
Ot
Ot
Ot
Ot
Ot
Ot
Ot
Ot
"}
(26,1,1) = {"
Ot
Ot
Ot
Ot
Ot
Ot
Ot
Ot
Ot
Ot
Yi
Yi
YA
NY
OG
YA
Yi
Yi
YA
YA
YA
aG
aG
aG
aG
Ot
Ot
Ot
Ot
Ot
"}
(27,1,1) = {"
Ot
Ot
Ot
Ot
Ot
Ot
Ot
Ot
Ot
Ot
Yi
Yi
YA
NY
OG
YA
Yi
Yi
YA
dl
Ch
aG
aG
DC
aG
aG
Ot
Ot
Ot
Ot
"}
(28,1,1) = {"
Ot
Ot
Ot
Ot
Ot
Ot
Ot
Ot
Ot
Ot
Yi
Yi
YA
NY
UH
YA
YA
YA
YA
ZR
Jv
kM
HV
hT
gF
aG
aG
Ot
Ot
Ot
"}
(29,1,1) = {"
Ot
Ot
Ot
Ot
Ot
Ot
Yi
Yi
Yi
Yi
Yi
Yi
YA
Lm
OG
qS
td
td
td
BC
td
iL
tf
Mo
Mo
HC
aG
Ot
Ot
Ot
"}
(30,1,1) = {"
Ot
Ot
Ot
Ot
Ot
Ot
Yi
Yi
Yi
Yi
Yi
Yi
YA
NY
OG
YA
YA
YA
cI
sz
Jv
kM
QA
qK
rJ
aG
aG
Ot
Ot
Ot
"}
(31,1,1) = {"
Ot
Ot
Ot
Ot
Ot
Ot
Yi
Yi
YA
YA
YA
YA
YA
NY
OG
YA
Yi
YA
fx
IQ
WA
aG
aG
rn
aG
aG
Ot
Ot
Ot
Ot
"}
(32,1,1) = {"
Ot
Ot
Ot
Ot
Ot
Yi
Yi
Yi
YA
td
zK
nW
nW
JB
OG
YA
Yi
YA
YA
YA
YA
aG
aG
aG
aG
Ot
Ot
Ot
Ot
Ot
"}
(33,1,1) = {"
Ot
Ot
Ot
Ot
Ot
Yi
Yi
Yi
YA
td
Yp
zK
nW
Ia
mT
YA
Yi
Yi
Ot
Ot
Ot
Ot
Ot
Ot
Ot
Ot
Ot
Ot
Ot
Ot
"}
(34,1,1) = {"
Ot
Ot
Ot
Ot
Yi
Yi
BX
BX
BX
BX
xG
xG
sd
bZ
hU
ZP
Yi
Yi
Ot
Ot
Ot
Ot
Ot
Ot
Ot
Ot
Ot
Ot
Ot
Ot
"}
(35,1,1) = {"
Ot
Ot
Ot
Ot
Yi
Yi
BX
he
Az
BO
xm
wN
zo
Kc
hU
ZP
Yi
Yi
Ot
Ot
Ot
Ot
Ot
Ot
Ot
Ot
Ot
Ot
Ot
Ot
"}
(36,1,1) = {"
Ot
Ot
Ot
Ot
Yi
Yi
BX
mP
Wf
mP
zm
AC
sd
td
hU
ZP
Yi
Yi
Ot
Ot
Ot
Ot
Ot
Ot
Ot
Ot
Ot
Ot
Ot
Ot
"}
(37,1,1) = {"
Ot
Ot
Ot
Ot
Yi
Yi
BX
eW
Ge
KP
Ck
CT
ko
QM
hJ
ZP
Yi
Yi
Ot
Ot
Ot
Ot
Ot
Ot
Ot
Ot
Ot
Ot
Ot
Ot
"}
(38,1,1) = {"
Ot
Ot
Ot
Ot
Yi
Yi
BX
gK
Ny
wy
uo
MY
ko
PU
SG
ZP
Yi
Yi
Ot
Ot
Ot
Ot
Ot
Ot
Ot
Ot
Ot
Ot
Ot
Ot
"}
(39,1,1) = {"
Ot
Ot
Ot
Ot
Yi
Yi
BX
cu
cR
wp
ui
GY
sd
td
td
ZP
Yi
Yi
Ot
Ot
Ot
Ot
Ot
Ot
Ot
Ot
Ot
Ot
Ot
Ot
"}
(40,1,1) = {"
Ot
Ot
Ot
Ot
ZP
ZP
BX
BX
BX
sd
sd
sd
BX
td
td
ZP
Yi
Yi
Ot
Ot
Ot
Ot
Ot
Ot
Ot
Ot
Ot
Ot
Ot
Ot
"}
(41,1,1) = {"
Ot
Ot
Ot
Ot
ZP
td
td
td
td
td
JH
td
td
td
td
ZP
Yi
Yi
Ot
Ot
Ot
Ot
Ot
Ot
Ot
Ot
Ot
Ot
Ot
Ot
"}
(42,1,1) = {"
Ot
Ot
Ot
Ot
ZP
td
td
td
ZP
ZP
ZP
ZP
ZP
ZP
ZP
ZP
Yi
Yi
Ot
Ot
Ot
Ot
Ot
Ot
Ot
Ot
Ot
Ot
Ot
Ot
"}
(43,1,1) = {"
Ot
Ot
Ot
Ot
ZP
td
td
td
ZP
Yi
Yi
Yi
Yi
Yi
Yi
Yi
Yi
Yi
Ot
Ot
Ot
Ot
Ot
Ot
Ot
Ot
Ot
Ot
Ot
Ot
"}
(44,1,1) = {"
Ot
Ot
Ot
Ot
ZP
td
td
td
ZP
Yi
Yi
Yi
Yi
Yi
Yi
Yi
Yi
Yi
Ot
Ot
Ot
Ot
Ot
Ot
Ot
Ot
Ot
Ot
Ot
Ot
"}
(45,1,1) = {"
Ot
Ot
Ot
Ot
ZP
td
td
td
ZP
Ot
Ot
Ot
Ot
Ot
Ot
Ot
Ot
Ot
Ot
Ot
Ot
Ot
Ot
Ot
Ot
Ot
Ot
Ot
Ot
Ot
"}
