//MAP CONVERTED BY dmm2tgm.py THIS HEADER COMMENT PREVENTS RECONVERSION, DO NOT REMOVE
"aa" = (
/obj/structure/window/reinforced/tinted{
	dir = 4
	},
/obj/machinery/space_heater,
/turf/open/pool,
/area/survivalpod)
"ab" = (
/obj/machinery/smartfridge/survival_pod,
/turf/open/floor/pod/dark,
/area/survivalpod)
"ac" = (
/obj/machinery/door/window/survival_pod{
	dir = 4
	},
/turf/open/floor/wood,
/area/survivalpod)
"ad" = (
/obj/structure/window/reinforced/spawner/east,
/obj/structure/window/reinforced/spawner/west,
/obj/structure/flora/grass/jungle,
/turf/open/floor/plating/dirt,
/area/survivalpod)
"ae" = (
/obj/structure/chair/sofa/corp/corner{
	dir = 4
	},
/turf/open/floor/wood,
/area/survivalpod)
"af" = (
/obj/machinery/stasis,
/turf/open/floor/carpet/black,
/area/survivalpod)
"ag" = (
/obj/structure/window/reinforced/tinted,
/turf/open/floor/wood,
/area/survivalpod)
"ah" = (
/obj/structure/flora/ausbushes/brflowers,
/obj/structure/window/reinforced/spawner/east,
/obj/structure/window/reinforced/spawner/west,
/obj/structure/window/reinforced/spawner/north,
/turf/open/floor/plating/dirt,
/area/survivalpod)
"ai" = (
/obj/structure/window/shuttle/survival_pod,
/obj/machinery/poweredfans,
/turf/open/floor/pod/dark,
/area/survivalpod)
"aj" = (
/obj/machinery/pool/controller,
/obj/structure/window/reinforced/tinted{
	dir = 4
	},
/obj/machinery/light{
	dir = 8
	},
/turf/open/floor/wood,
/area/survivalpod)
"ak" = (
/obj/machinery/computer/operating,
/obj/item/clothing/gloves/color/latex/nitrile,
/turf/open/floor/plasteel/white/textured/large,
/area/survivalpod)
"al" = (
/turf/open/pool,
/area/survivalpod)
"am" = (
/obj/machinery/shower,
/turf/open/pool,
/area/survivalpod)
"an" = (
/obj/machinery/light{
	dir = 4
	},
/obj/machinery/vending/barkbox,
/turf/open/floor/pod/dark,
/area/survivalpod)
"ao" = (
/turf/open/floor/carpet/royalblue,
/area/survivalpod)
"ap" = (
/obj/structure/flora/ausbushes/fullgrass,
/obj/structure/window/reinforced/spawner/east,
/obj/structure/window/reinforced/spawner,
/obj/structure/window/reinforced/spawner/west,
/turf/open/floor/plating/dirt,
/area/survivalpod)
"aq" = (
/obj/structure/pool/ladder,
/turf/open/pool,
/area/survivalpod)
"ar" = (
/obj/machinery/light/floor/built,
/turf/open/pool,
/area/survivalpod)
"as" = (
/obj/machinery/light{
	dir = 1
	},
/turf/open/floor/wood,
/area/survivalpod)
"at" = (
/obj/structure/sign/poster/contraband/yes_erp,
/turf/closed/wall/mineral/titanium/survival/pod,
/area/survivalpod)
"au" = (
/obj/machinery/light{
	dir = 8
	},
/turf/open/floor/carpet/royalblue,
/area/survivalpod)
"av" = (
/obj/structure/window/reinforced/tinted{
	dir = 1
	},
/turf/open/floor/carpet/purple,
/area/survivalpod)
"aw" = (
/obj/structure/pool/ladder{
	dir = 1;
	pixel_y = -24
	},
/turf/open/pool,
/area/survivalpod)
"ax" = (
/turf/open/floor/carpet/royalblack,
/area/survivalpod)
"ay" = (
/obj/structure/flora/bush,
/obj/structure/window/reinforced/spawner/east,
/obj/structure/window/reinforced/spawner/west,
/obj/structure/window/reinforced/spawner/north,
/turf/open/floor/plating/dirt,
/area/survivalpod)
"az" = (
/obj/machinery/light{
	dir = 1
	},
/obj/structure/window/reinforced/spawner/west,
/turf/open/floor/carpet/black,
/area/survivalpod)
"aA" = (
/turf/open/floor/carpet/blue,
/area/survivalpod)
"aC" = (
/obj/structure/window/reinforced/tinted{
	dir = 4
	},
/turf/open/pool,
/area/survivalpod)
"aD" = (
/obj/structure/window/reinforced/tinted{
	dir = 4
	},
/obj/machinery/vending/donksofttoyvendor,
/turf/open/floor/pod/dark,
/area/survivalpod)
"aE" = (
/obj/structure/window/reinforced/tinted{
	dir = 1
	},
/obj/machinery/light,
/turf/open/floor/wood,
/area/survivalpod)
"aF" = (
/obj/structure/flora/junglebush,
/obj/structure/window/reinforced/spawner/east,
/obj/structure/window/reinforced/spawner/west,
/turf/open/floor/plating/dirt,
/area/survivalpod)
"aG" = (
/turf/open/floor/grass/grass0,
/area/survivalpod)
"aH" = (
/obj/machinery/light,
/obj/structure/window/reinforced/spawner/west,
/turf/open/floor/carpet/blackred,
/area/survivalpod)
"aI" = (
/obj/structure/window/reinforced/spawner/east,
/obj/structure/window/reinforced/spawner/west,
/obj/structure/flora/grass/brown,
/turf/open/floor/plating/dirt,
/area/survivalpod)
"aJ" = (
/obj/structure/flora/ausbushes/stalkybush,
/obj/structure/window/reinforced/spawner/east,
/obj/structure/window/reinforced/spawner/west,
/turf/open/floor/plating/dirt,
/area/survivalpod)
"aL" = (
/obj/machinery/light{
	dir = 4;
	light_color = "#DDFFD3"
	},
/turf/open/floor/carpet/royalblue,
/area/survivalpod)
"aM" = (
/obj/structure/sign/poster/contraband/donut_corp,
/turf/closed/wall/mineral/titanium/survival/pod,
/area/survivalpod)
"aN" = (
/obj/machinery/door/airlock/survival_pod/glass,
/obj/machinery/poweredfans,
/turf/open/floor/wood,
/area/survivalpod)
"aO" = (
/obj/machinery/processor,
/turf/open/floor/mineral/titanium/white,
/area/survivalpod)
"aP" = (
/obj/structure/flora/ausbushes/reedbush,
/obj/structure/window/reinforced/spawner/east,
/obj/structure/window/reinforced/spawner/west,
/turf/open/floor/plating/dirt,
/area/survivalpod)
"aQ" = (
/obj/structure/window/reinforced/spawner,
/turf/open/floor/plasteel/white/textured/large,
/area/survivalpod)
"aR" = (
/turf/open/floor/carpet/black,
/area/survivalpod)
"aS" = (
/obj/structure/window/reinforced/tinted{
	dir = 4
	},
/obj/structure/reagent_dispensers/water_cooler,
/turf/open/floor/wood,
/area/survivalpod)
"aT" = (
/obj/machinery/light{
	dir = 4
	},
/turf/open/floor/carpet/royalblue,
/area/survivalpod)
"aU" = (
/obj/machinery/door/airlock/survival_pod,
/turf/open/floor/wood,
/area/survivalpod)
"aV" = (
/obj/machinery/light{
	dir = 8
	},
/turf/open/floor/pod/dark,
/area/survivalpod)
"aW" = (
/obj/structure/reagent_dispensers/watertank,
/turf/open/floor/grass/grass0,
/area/survivalpod)
"aX" = (
/turf/open/floor/pod/dark,
/area/survivalpod)
"aY" = (
/obj/machinery/icecream_vat,
/obj/machinery/light{
	dir = 8
	},
/turf/open/floor/mineral/titanium/white,
/area/survivalpod)
"bb" = (
/obj/structure/chair/comfy/black,
/turf/open/floor/wood,
/area/survivalpod)
"bc" = (
/turf/open/floor/wood,
/area/survivalpod)
"bd" = (
/obj/structure/chair/comfy/black{
	dir = 1
	},
/turf/open/floor/wood,
/area/survivalpod)
"be" = (
/obj/structure/chair/comfy/green,
/turf/open/floor/wood,
/area/survivalpod)
"bf" = (
/obj/structure/window/reinforced/tinted{
	dir = 1
	},
/turf/open/floor/wood,
/area/survivalpod)
"bg" = (
/turf/open/floor/mineral/titanium/white,
/area/survivalpod)
"bi" = (
/obj/structure/window/reinforced/spawner/east,
/obj/structure/window/reinforced/spawner/west,
/obj/structure/flora/ausbushes/brflowers,
/turf/open/floor/plating/dirt,
/area/survivalpod)
"bj" = (
/obj/structure/bed/double,
/obj/item/bedsheet/patriot/double,
/turf/open/floor/wood,
/area/survivalpod)
"bk" = (
/obj/machinery/light,
/turf/open/floor/carpet/black,
/area/survivalpod)
"bm" = (
/obj/machinery/recharge_station/fullupgrade,
/turf/open/floor/pod/dark,
/area/survivalpod)
"bn" = (
/obj/structure/table/wood,
/obj/item/flashlight/lamp/green,
/turf/open/floor/wood,
/area/survivalpod)
"bo" = (
/obj/structure/bed/double,
/obj/item/bedsheet/nanotrasen/double,
/turf/open/floor/wood,
/area/survivalpod)
"bp" = (
/obj/structure/chair/comfy/lime,
/turf/open/floor/wood,
/area/survivalpod)
"bs" = (
/obj/machinery/vending/snack/random,
/turf/open/floor/wood,
/area/survivalpod)
"bv" = (
/obj/machinery/computer/arcade/battle{
	dir = 4
	},
/turf/open/floor/wood,
/area/survivalpod)
"dj" = (
/obj/item/kirbyplants,
/turf/open/floor/grass/grass0,
/area/survivalpod)
"du" = (
/obj/item/storage/toolbox/syndicate,
/obj/structure/table/plasmaglass,
/turf/open/floor/carpet/black,
/area/survivalpod)
"et" = (
/obj/structure/chair/comfy/black,
/obj/item/toy/plush/goatplushie,
/turf/open/floor/wood,
/area/survivalpod)
"eA" = (
/obj/machinery/biogenerator,
/obj/machinery/poweredfans,
/turf/open/floor/pod/dark,
/area/survivalpod)
"fl" = (
/obj/structure/sign/poster/contraband/space_cola,
/turf/closed/wall/mineral/titanium/survival/pod,
/area/survivalpod)
"ge" = (
/obj/machinery/light{
	dir = 1
	},
/turf/open/floor/carpet/black,
/area/survivalpod)
"go" = (
/obj/machinery/sleeper{
	dir = 8
	},
/turf/open/floor/carpet/black,
/area/survivalpod)
"gI" = (
/obj/structure/chair/stool,
/obj/machinery/light/floor,
/turf/open/floor/wood,
/area/survivalpod)
"gK" = (
/obj/item/kirbyplants/photosynthetic,
/turf/open/floor/wood,
/area/survivalpod)
"hy" = (
/obj/structure/table/wood/fancy,
/obj/item/reagent_containers/food/condiment/peppermill{
	pixel_x = -4;
	pixel_y = 12
	},
/obj/item/reagent_containers/food/condiment/saltshaker{
	pixel_x = 4;
	pixel_y = 4
	},
/turf/open/floor/wood,
/area/survivalpod)
"hD" = (
/obj/structure/table/reinforced,
/obj/item/reagent_containers/rag{
	pixel_y = 15;
	pixel_x = 10
	},
/turf/open/floor/mineral/titanium/white,
/area/survivalpod)
"ie" = (
/obj/machinery/computer/arcade/tetris{
	dir = 4
	},
/turf/open/floor/wood,
/area/survivalpod)
"if" = (
/obj/structure/sign/poster/contraband/tools,
/turf/closed/wall/mineral/titanium/survival/pod,
/area/survivalpod)
"ik" = (
/obj/machinery/vending/dinnerware,
/turf/open/floor/mineral/titanium/white,
/area/survivalpod)
"iu" = (
/obj/structure/flora/ausbushes/leafybush,
/obj/structure/window/reinforced/spawner/east,
/obj/structure/window/reinforced/spawner/west,
/obj/structure/window/reinforced/spawner,
/turf/open/floor/plating/dirt,
/area/survivalpod)
"jh" = (
/obj/item/toy/plush/beeplushie,
/turf/open/floor/grass/grass0,
/area/survivalpod)
"jj" = (
/obj/machinery/research_table,
/obj/effect/turf_decal/bot,
/turf/open/floor/carpet/royalblack,
/area/survivalpod)
"jq" = (
/obj/structure/table/plasmaglass,
/obj/machinery/plantgenes,
/turf/open/floor/grass/grass0,
/area/survivalpod)
"jw" = (
/obj/machinery/telecomms/relay/preset/station,
/obj/item/multitool,
/turf/open/floor/pod/dark,
/area/survivalpod)
"jZ" = (
/obj/structure/flora/ausbushes/palebush,
/obj/structure/window/reinforced/spawner/east,
/obj/structure/window/reinforced/spawner/north,
/obj/structure/window/reinforced/spawner/west,
/turf/open/floor/plating/dirt,
/area/survivalpod)
"kf" = (
/obj/structure/rack,
/obj/item/storage/box/ingredients/wildcard,
/obj/item/storage/box/ingredients/wildcard,
/obj/item/storage/box/ingredients/wildcard,
/obj/item/storage/box/ingredients/vegetarian,
/obj/item/storage/box/ingredients/exotic,
/obj/item/storage/box/ingredients/delights,
/turf/open/floor/mineral/titanium/white,
/area/survivalpod)
"kA" = (
/obj/structure/chair/sofa/corp/right{
	dir = 8
	},
/obj/structure/window/reinforced/tinted{
	dir = 4
	},
/turf/open/floor/wood,
/area/survivalpod)
"kI" = (
/obj/structure/table/reinforced,
/obj/machinery/microwave,
/turf/open/floor/mineral/titanium/white,
/area/survivalpod)
"lf" = (
/obj/machinery/door/airlock/survival_pod/glass,
/obj/machinery/poweredfans,
/turf/open/floor/carpet/royalblack,
/area/survivalpod)
"lg" = (
/obj/machinery/vr_sleeper,
/obj/machinery/light{
	dir = 1;
	light_color = "#cee5d2"
	},
/turf/open/floor/carpet/blue,
/area/survivalpod)
"lA" = (
/obj/structure/window/reinforced/spawner/east,
/obj/structure/window/reinforced/spawner,
/obj/structure/window/reinforced/spawner/west,
/obj/structure/flora/grass/spookytime,
/turf/open/floor/plating/dirt,
/area/survivalpod)
"lT" = (
/obj/structure/sign/poster/contraband/ambrosia_vulgaris,
/turf/closed/wall/mineral/titanium/survival/pod,
/area/survivalpod)
"mJ" = (
/obj/structure/table/reinforced,
/obj/item/reagent_containers/food/snacks/store/cake/birthday,
/turf/open/floor/mineral/titanium/white,
/area/survivalpod)
"nc" = (
/obj/structure/closet/secure_closet/freezer/kitchen{
	req_access = null
	},
/obj/item/reagent_containers/food/snacks/breadslice/plain,
/obj/item/reagent_containers/food/snacks/breadslice/plain,
/obj/item/reagent_containers/food/snacks/breadslice/plain,
/obj/item/reagent_containers/food/snacks/grown/potato,
/obj/item/reagent_containers/food/snacks/grown/potato,
/obj/effect/spawner/lootdrop/prison_loot_toilet,
/obj/item/reagent_containers/food/snacks/grown/onion,
/obj/item/reagent_containers/food/snacks/grown/onion,
/obj/item/choice_beacon/ingredients,
/obj/item/choice_beacon/ingredients,
/obj/effect/turf_decal/bot_white,
/obj/item/storage/box/ingredients/carnivore,
/obj/item/storage/box/ingredients/wildcard,
/obj/item/storage/fancy/egg_box,
/obj/effect/turf_decal/bot_blue,
/turf/open/floor/mineral/titanium/white,
/area/survivalpod)
"os" = (
/obj/structure/table/wood/fancy/black,
/turf/open/floor/wood,
/area/survivalpod)
"ox" = (
/obj/machinery/door/airlock/survival_pod,
/obj/machinery/poweredfans,
/turf/open/floor/carpet/royalblue,
/area/survivalpod)
"oM" = (
/obj/structure/table/reinforced,
/obj/item/pizzabox/margherita,
/obj/item/pizzabox/margherita,
/obj/item/pizzabox/mushroom,
/obj/item/pizzabox/mushroom,
/obj/item/pizzabox/meat,
/obj/item/pizzabox/meat,
/turf/open/floor/mineral/titanium/white,
/area/survivalpod)
"oO" = (
/obj/structure/table/plasmaglass,
/obj/machinery/smartfridge/disks,
/turf/open/floor/grass/grass0,
/area/survivalpod)
"oQ" = (
/obj/item/clothing/under/rank/security/skirt/slut/pink,
/obj/item/clothing/shoes/jackboots,
/obj/item/storage/belt/slut,
/obj/structure/closet/secure_closet/personal{
	req_access = list(12)
	},
/obj/item/clothing/under/rank/security/officer{
	armor = null
	},
/obj/item/electropack/shockcollar/security,
/obj/item/leash,
/obj/item/dildo/flared/gigantic{
	pixel_y = 2;
	pixel_x = 6
	},
/turf/open/floor/carpet/royalblack,
/area/survivalpod)
"pp" = (
/obj/structure/sign/poster/contraband/eat,
/turf/closed/wall/mineral/titanium/survival/pod,
/area/survivalpod)
"pu" = (
/obj/structure/window/reinforced/tinted{
	dir = 4
	},
/obj/machinery/light{
	dir = 8
	},
/turf/open/floor/wood,
/area/survivalpod)
"pU" = (
/obj/structure/fans,
/turf/open/floor/pod/dark,
/area/survivalpod)
"qk" = (
/obj/structure/chair/comfy/black{
	dir = 1
	},
/obj/item/toy/plush/lizardplushie,
/turf/open/floor/wood,
/area/survivalpod)
"qR" = (
/obj/machinery/deepfryer,
/turf/open/floor/mineral/titanium/white,
/area/survivalpod)
"qV" = (
/obj/structure/chair/stool,
/turf/open/floor/wood,
/area/survivalpod)
"ro" = (
/mob/living/simple_animal/bot/secbot/grievous/toy,
/turf/open/floor/wood,
/area/survivalpod)
"rA" = (
/obj/structure/sign/poster/contraband/cybersun,
/turf/closed/wall/mineral/titanium/survival/pod,
/area/survivalpod)
"rD" = (
/obj/machinery/hydroponics/constructable/automagic,
/turf/open/floor/grass/grass0,
/area/survivalpod)
"sd" = (
/turf/open/floor/carpet/purple,
/area/survivalpod)
"sk" = (
/obj/machinery/door/airlock/survival_pod/glass,
/obj/machinery/poweredfans,
/turf/open/floor/carpet/black,
/area/survivalpod)
"su" = (
/obj/structure/table/reinforced,
/obj/machinery/reagentgrinder,
/obj/item/clothing/head/chefhat,
/turf/open/floor/mineral/titanium/white,
/area/survivalpod)
"sF" = (
/obj/machinery/recharge_station/fullupgrade,
/obj/machinery/light{
	dir = 8
	},
/turf/open/floor/pod/dark,
/area/survivalpod)
"sH" = (
/obj/structure/window/reinforced/tinted{
	dir = 4
	},
/obj/machinery/vending/cigarette/syndicate,
/turf/open/floor/wood,
/area/survivalpod)
"sI" = (
/obj/machinery/door/airlock/survival_pod/glass,
/obj/machinery/poweredfans,
/turf/open/floor/pod/dark,
/area/survivalpod)
"tt" = (
/obj/effect/decal/cleanable/semen,
/turf/open/floor/carpet/purple,
/area/survivalpod)
"tB" = (
/obj/structure/sign/poster/contraband/crocin_pool,
/turf/closed/wall/mineral/titanium/survival/pod,
/area/survivalpod)
"tG" = (
/obj/machinery/light{
	dir = 1
	},
/turf/open/floor/grass/grass0,
/area/survivalpod)
"tK" = (
/obj/structure/chair/comfy/black,
/obj/item/toy/plush/carpplushie,
/turf/open/floor/wood,
/area/survivalpod)
"tQ" = (
/obj/structure/bed/double,
/obj/effect/turf_decal/bot,
/obj/item/bedsheet/centcom/double,
/turf/open/floor/carpet/royalblack,
/area/survivalpod)
"uB" = (
/obj/structure/table/optable/abductor,
/turf/open/floor/plasteel/white/textured/large,
/area/survivalpod)
"uZ" = (
/obj/structure/closet/secure_closet/hydroponics{
	req_access = null
	},
/turf/open/floor/grass/grass0,
/area/survivalpod)
"ve" = (
/obj/effect/decal/cleanable/semen/femcum,
/obj/structure/chair/gloryhole,
/obj/machinery/light,
/turf/open/floor/carpet/purple,
/area/survivalpod)
"vi" = (
/obj/structure/table/reinforced,
/obj/effect/spawner/lootdrop/three_course_meal,
/obj/effect/spawner/lootdrop/three_course_meal,
/obj/effect/spawner/lootdrop/three_course_meal,
/turf/open/floor/mineral/titanium/white,
/area/survivalpod)
"vk" = (
/obj/structure/reagent_dispensers/keg/semen,
/obj/machinery/light{
	dir = 4
	},
/turf/open/floor/carpet/royalblack,
/area/survivalpod)
"vP" = (
/obj/structure/chair/sofa/corp,
/turf/open/floor/wood,
/area/survivalpod)
"vW" = (
/obj/machinery/smartfridge/food,
/turf/open/floor/pod/dark,
/area/survivalpod)
"xE" = (
/obj/machinery/pool/drain,
/turf/open/pool,
/area/survivalpod)
"yx" = (
/obj/structure/table/reinforced,
/obj/item/storage/bag/tray/bluespace,
/obj/item/book/manual/wiki/cooking_to_serve_man{
	pixel_x = 4;
	pixel_y = 3
	},
/obj/machinery/light{
	dir = 1
	},
/turf/open/floor/mineral/titanium/white,
/area/survivalpod)
"zp" = (
/obj/structure/sink/kitchen{
	dir = 4;
	pixel_x = -13
	},
/turf/open/floor/grass/grass0,
/area/survivalpod)
"zx" = (
/obj/machinery/vending/hydroseeds,
/turf/open/floor/grass/grass0,
/area/survivalpod)
"zX" = (
/obj/structure/bed/double,
/obj/item/bedsheet/syndie/double,
/turf/open/floor/wood,
/area/survivalpod)
"Aj" = (
/obj/structure/chair/comfy/black{
	dir = 1
	},
/obj/item/toy/plush/bm/silly_neko_plushie,
/turf/open/floor/wood,
/area/survivalpod)
"AS" = (
/obj/structure/reagent_dispensers/keg/aphro/strong,
/turf/open/floor/carpet/royalblack,
/area/survivalpod)
"BA" = (
/obj/structure/curtain,
/turf/open/floor/carpet/royalblack,
/area/survivalpod)
"BW" = (
/obj/structure/sign/poster/contraband/syndicate_medical,
/turf/closed/wall/mineral/titanium/survival/pod,
/area/survivalpod)
"Cs" = (
/obj/machinery/grill,
/obj/machinery/light{
	dir = 1
	},
/turf/open/floor/mineral/titanium/white,
/area/survivalpod)
"CI" = (
/obj/machinery/jukebox{
	req_one_access = null
	},
/turf/open/floor/wood,
/area/survivalpod)
"Dd" = (
/obj/machinery/vending/hydronutrients,
/turf/open/floor/grass/grass0,
/area/survivalpod)
"Dt" = (
/obj/structure/table/wood/fancy,
/obj/machinery/light/floor,
/turf/open/floor/wood,
/area/survivalpod)
"ET" = (
/obj/structure/chair/sofa/corp,
/obj/machinery/light/floor,
/turf/open/floor/wood,
/area/survivalpod)
"FP" = (
/obj/structure/table/reinforced,
/obj/machinery/chem_dispenser/drinks,
/turf/open/floor/mineral/titanium/white,
/area/survivalpod)
"Hl" = (
/obj/structure/table/plasmaglass,
/obj/item/reagent_containers/glass/bucket,
/obj/machinery/light{
	dir = 4
	},
/obj/item/plant_analyzer,
/obj/item/gun/energy/floragun,
/turf/open/floor/grass/grass0,
/area/survivalpod)
"HN" = (
/obj/machinery/computer/arcade/orion_trail{
	dir = 4
	},
/turf/open/floor/wood,
/area/survivalpod)
"Ij" = (
/obj/structure/flora/ausbushes/pointybush,
/obj/structure/window/reinforced/spawner/east,
/obj/structure/window/reinforced/spawner/west,
/obj/structure/window/reinforced/spawner,
/turf/open/floor/plating/dirt,
/area/survivalpod)
"Jb" = (
/turf/closed/wall/mineral/titanium/survival,
/area/survivalpod)
"JP" = (
/obj/structure/sink/kitchen{
	dir = 4;
	pixel_x = -11
	},
/obj/machinery/light{
	dir = 8
	},
/turf/open/floor/mineral/titanium/white,
/area/survivalpod)
"Lb" = (
/obj/structure/table/reinforced,
/obj/machinery/chem_dispenser/drinks/beer,
/turf/open/floor/mineral/titanium/white,
/area/survivalpod)
"Lx" = (
/obj/effect/spawner/lootdrop/costume,
/obj/structure/closet/crate/wooden,
/turf/open/floor/pod/dark,
/area/survivalpod)
"LT" = (
/mob/living/simple_animal/bot/cleanbot,
/turf/open/floor/wood,
/area/survivalpod)
"Mk" = (
/obj/machinery/light,
/turf/open/floor/grass/grass0,
/area/survivalpod)
"MH" = (
/obj/machinery/vr_sleeper,
/turf/open/floor/carpet/blue,
/area/survivalpod)
"MM" = (
/obj/machinery/vending/boozeomat,
/turf/open/floor/wood,
/area/survivalpod)
"Ne" = (
/obj/structure/chair/sofa/corp/corner,
/obj/structure/window/reinforced/tinted{
	dir = 4
	},
/turf/open/floor/wood,
/area/survivalpod)
"Ni" = (
/obj/item/restraints/handcuffs/kinky,
/obj/structure/table/plasmaglass,
/obj/item/bdsm_whip,
/obj/item/clothing/head/dominatrixcap,
/obj/machinery/light{
	dir = 4
	},
/turf/open/floor/carpet/royalblack,
/area/survivalpod)
"NW" = (
/obj/machinery/vending/autodrobe/all_access,
/turf/open/floor/pod/dark,
/area/survivalpod)
"Og" = (
/obj/structure/closet/secure_closet/personal/cabinet,
/obj/item/clothing/under/misc/bathrobe,
/obj/machinery/light{
	dir = 1
	},
/turf/open/floor/wood,
/area/survivalpod)
"On" = (
/obj/machinery/vending/clothing,
/turf/open/floor/pod/dark,
/area/survivalpod)
"Oz" = (
/obj/machinery/light{
	dir = 4
	},
/obj/structure/window/reinforced/spawner,
/obj/structure/table/plasmaglass,
/turf/open/floor/carpet/black,
/area/survivalpod)
"OB" = (
/obj/structure/window/reinforced/spawner/east,
/obj/structure/window/reinforced/spawner/north,
/obj/structure/window/reinforced/spawner/west,
/obj/structure/flora/rock/jungle,
/turf/open/floor/plating/dirt,
/area/survivalpod)
"OU" = (
/obj/machinery/door/airlock/survival_pod,
/turf/open/floor/carpet/royalblack,
/area/survivalpod)
"PW" = (
/obj/structure/window/reinforced/spawner,
/turf/open/floor/carpet/black,
/area/survivalpod)
"Qn" = (
/turf/open/floor/carpet/blackred,
/area/survivalpod)
"RM" = (
/obj/effect/spawner/lootdrop/pizzaparty,
/obj/structure/closet/crate/wooden,
/turf/open/floor/pod/dark,
/area/survivalpod)
"Sp" = (
/turf/closed/wall/mineral/titanium/survival/pod,
/area/survivalpod)
"SI" = (
/obj/machinery/light/floor,
/turf/open/floor/wood,
/area/survivalpod)
"SM" = (
/obj/machinery/seed_extractor,
/turf/open/floor/grass/grass0,
/area/survivalpod)
"TB" = (
/obj/machinery/mineral/equipment_vendor,
/turf/open/floor/pod/dark,
/area/survivalpod)
"TC" = (
/obj/machinery/door/airlock/survival_pod,
/obj/machinery/poweredfans,
/turf/open/floor/wood,
/area/survivalpod)
"TE" = (
/obj/machinery/light{
	dir = 4;
	light_color = "#DDFFD3"
	},
/turf/open/floor/mineral/titanium/white,
/area/survivalpod)
"Uc" = (
/obj/structure/window/reinforced/tinted{
	dir = 1
	},
/obj/effect/decal/cleanable/semen,
/turf/open/floor/carpet/purple,
/area/survivalpod)
"Xg" = (
/obj/structure/table/wood/fancy/black,
/obj/item/reagent_containers/glass/beaker/waterbottle/wataur,
/turf/open/floor/wood,
/area/survivalpod)
"Yk" = (
/obj/machinery/door/airlock/survival_pod,
/obj/machinery/poweredfans,
/turf/open/floor/grass/grass0,
/area/survivalpod)
"YA" = (
/obj/machinery/autolathe,
/turf/open/floor/carpet/black,
/area/survivalpod)
"YP" = (
/obj/structure/chair/sofa/corp/left{
	dir = 4
	},
/turf/open/floor/wood,
/area/survivalpod)
"Zy" = (
/obj/machinery/vending/kink{
	extended_inventory = 1;
	shut_up = 1
	},
/turf/open/floor/carpet/royalblack,
/area/survivalpod)

(1,1,1) = {"
Sp
Sp
Sp
fl
aM
pp
ai
ai
ai
ai
ai
ai
Sp
Sp
Sp
Sp
Sp
Sp
Sp
Sp
Sp
Sp
Sp
Sp
Sp
"}
(2,1,1) = {"
Sp
nc
JP
aO
aY
FP
et
hy
Aj
ie
HN
bv
ai
ag
aj
bc
pu
bc
Sp
bc
Sp
Og
bb
bn
ai
"}
(3,1,1) = {"
Sp
kf
bg
bg
bg
Lb
tK
Dt
qk
qV
gI
qV
ai
ag
al
aq
al
aE
Sp
as
aU
bc
bc
bj
ai
"}
(4,1,1) = {"
Sp
yx
bg
bg
bg
oM
bc
CI
ro
bc
bc
MM
ai
ag
al
ar
al
bf
Sp
bc
Sp
Sp
Sp
Sp
Sp
"}
(5,1,1) = {"
Sp
su
bg
bg
bg
vi
bc
bc
LT
bc
bc
bs
ai
ag
am
xE
aw
bc
aU
bc
Sp
Og
be
bn
ai
"}
(6,1,1) = {"
Sp
kI
bg
bg
bg
vi
bc
bc
bc
bc
bc
gK
ai
ag
am
xE
aw
bc
aU
bc
aU
bc
bc
zX
ai
"}
(7,1,1) = {"
Sp
Cs
bg
bg
bg
hD
bd
bc
bc
bc
ae
YP
ai
ag
al
ar
al
bf
Sp
bc
Sp
Sp
Sp
Sp
Sp
"}
(8,1,1) = {"
Sp
ik
bg
bg
bg
mJ
bd
bc
bc
bc
vP
os
ai
ag
aC
aa
aC
aE
Sp
as
Sp
Og
bp
bn
ai
"}
(9,1,1) = {"
Sp
qR
TE
bg
TE
bg
bc
SI
bc
bc
ET
Xg
ai
bc
bc
bc
bc
bc
Sp
bc
aU
bc
bc
bo
ai
"}
(10,1,1) = {"
Sp
Jb
Jb
TC
Jb
vW
aS
sH
ac
ac
Ne
kA
ai
ai
ai
ai
ai
ai
tB
aN
tB
Sp
Sp
Sp
Sp
"}
(11,1,1) = {"
ox
ao
ao
ao
ao
ao
ao
ao
ao
ao
ao
ao
ao
ao
ao
ao
ao
ao
au
ao
ao
ao
au
ao
ox
"}
(12,1,1) = {"
ox
ao
ao
ao
OB
ad
bi
aI
lA
ao
jZ
Ij
ao
ah
ap
ao
ay
aF
aJ
aP
iu
ao
ao
ao
ox
"}
(13,1,1) = {"
ox
ao
ao
ao
ao
ao
aL
ao
ao
ao
ao
ao
aT
ao
ao
ao
ao
ao
aL
ao
ao
ao
aL
ao
ox
"}
(14,1,1) = {"
Sp
Sp
lT
Yk
lT
eA
Sp
Sp
rA
sk
BW
Sp
Sp
Sp
at
lf
at
Sp
Sp
Sp
if
sI
if
Sp
Sp
"}
(15,1,1) = {"
Sp
uZ
zp
aG
aG
aG
Sp
ak
aQ
aR
aR
aR
Sp
MH
aA
aA
av
tt
Sp
aX
aV
aX
sF
bm
Sp
"}
(16,1,1) = {"
Sp
tG
aG
aG
aG
Mk
Sp
uB
aQ
aR
aR
aR
Sp
lg
aA
aA
av
ve
Sp
aX
aX
aX
aX
aX
Sp
"}
(17,1,1) = {"
Sp
rD
aG
aG
aG
jh
Sp
az
aR
aR
aR
bk
Sp
MH
aA
aA
Uc
sd
Sp
aX
aX
aX
aX
Lx
Sp
"}
(18,1,1) = {"
Sp
rD
aG
aG
aG
SM
Sp
aR
aR
aR
aR
YA
Sp
Sp
Sp
BA
Sp
OU
Sp
On
aX
aX
aX
RM
Sp
"}
(19,1,1) = {"
Sp
rD
aG
aG
aG
Dd
Sp
aR
aR
aR
aR
du
Sp
oQ
ax
ax
ax
ax
Sp
NW
aX
aX
aX
RM
Sp
"}
(20,1,1) = {"
Sp
rD
aG
aG
aG
zx
Sp
ge
aR
PW
Qn
aH
Sp
jj
ax
ax
ax
ax
Sp
aD
aX
aX
aX
Lx
Sp
"}
(21,1,1) = {"
Sp
tG
aG
aG
aG
Mk
Sp
aR
aR
PW
Qn
Qn
Sp
ax
ax
ax
ax
ax
Sp
pU
aX
aX
aX
aX
Sp
"}
(22,1,1) = {"
Sp
dj
jq
Hl
oO
aW
Sp
af
go
Oz
Qn
Qn
Sp
Zy
Ni
AS
vk
tQ
Sp
ab
aX
an
TB
jw
Sp
"}
(23,1,1) = {"
Sp
Sp
Sp
Sp
Sp
Sp
Sp
Sp
Sp
Sp
Sp
Sp
Sp
Sp
Sp
Sp
Sp
Sp
Sp
Sp
Sp
Sp
Sp
Sp
Sp
"}
